00020100020100010002010101000102010101010700000100000107020000010001020207000000020002010102020201000102000201000100010100020100020200000001000102020202010000020001060001000101000200010001080108020802
08060106020101000002000100020100000100020001010202010201000500000802010202010000020201000200050200010001080100000002000100000001020001020201010102020200010000000102020802010100050102010202010100010000
01020000000106010101020802010200010002000102020001010002020200020102000100000800000008020100010101060102060207020202010200010700000000060202000100010101020001010201000002010101010000000202000002010001
00000101020102020101010000000800010200010001000702000601010200020001000606010202020200020201020101010006020100010201010102000201010001020001020201020202080201000002000102010002070202020101000200020101
00070100010000010006000100020707000106010000060000000202010201010201020001010201020000020500060101010201020001050100010100020202020001010001000100000201020000000201000001020602000102010202000200000105
05000206000101070202000100020200070200020101020202000201000100000102020200020000020201010102010201020000010102010102000001010000020201050102020201070000000202070002010201000100000102020200010000010202
02010202020100010100020002000001000000000102010201020800000002010000010001000202020102010201010201010101000102000002010201010200010101000200020000020006010102020202010001020001020002000206000000020002
08020501000200020102020001010101000202020201010201010000000101010100020102020101010202020601020001000002020100010202020100060002000000000100020001000201000202000102000005010002010000000202000100010201
01020102020102020002060202000001020102020102020200020007020200010200020702050202000102000202000102000200010002020101020102020002070000000101000000000200000001000001000202010200000200000202000201020108
01000200000000000202010202010000020201010800010001020100020702000006010200010201000202070101050002000102000202000000010201000502020202000200020102000100010702000000000000020200000202010101010100080202
02010001020002020008010201000100000106020100010200020201070208000102020002010101000000000802020800010101020202000700010201000502020200010000000201010002020201050100020105020502010102000102010102020100
02000100010000000201010200000200010001020600000002020200010206010101000501020005010201000502010102020200020202000000010207000101010101000802020102020202020000010001020100060101020000020201000001010002
01020002000002020001020202020201020102020002020102010201010101000001060002010102000001000201020101000202000101000202060207000200010600020100010002000208010000020201050008070000020101010202060200010106
02020000020102020102060505020000010100070000060000000101000001020201000001020001000602020802020801080000010001000001010000020105000000020102020102010006020200010101010201020001000101050000020005070202
01000002050008060002010202010206000200060201010102000106010100020100010102010101020602020200060100020201010000080000020200020002010101010107020102020002010000020102000202010000020200000101000200000102
01020002000001020002010202000200000002000201020202020202050200010001000000020201000802010202000202020200010102010205010101010201020702020601010202020102010001010200070802020001050202000000000601010101
00000002020602020202020102020202020202020000020501020201000702020000010002000102010001020001000000000200000200020201000000000201010202000202000201000000000208080007010102000200010001080001010201020002
00000201010008000002020201010101020200010106000000070200020201010200010600000000000102010102000100000102010202010002020102000001060502010001010002020201020101070107060202010000010002020101000502010002
01020507000202010002000001010106050202020202000001020000020501020102010001020101000101080002000100000601000200080000000200020205010202000102020102010000020000020002000200020202020201000202020102000501
00020102000002010202000201010002000101000001000501000001020102010002070002020201020101020801010700000202010201000102010108010201000001020102020100080101010102020108020600020000070002010200020000020101
00020102020107020001010200020002010001020205000100000102020100000208000602020702010002000200000201000100050001010001010101000102020001050101020100020800010201020201010000000102020202020107010100000202
02020205010200000200020002010202020800020102020201000202020000010801000702020200000207020208000202020102010101000206000205020000000100010001020201020101020100020205020100000002020808000102020201050000
00010201010100080100020101050102010002000100000101020102010102020200010107020107010800020202010701020200010002010202020102000008010200020200010000010201010000000101000000010002010102020101020201000101
01010102010001010002000102020202050000020101020001000200010208010000060200000108020200000101000002070501000201010100010001010001000000010100010202010100000201020201010101010102010101000107000101000108
02000702020200010102010001010108000001000207020102000101020101010201060000020202000100020100010007000200000101020000000202000201010001020200020001020001020207020001020100010805050002020008000000010102
02020202020100070200010101010201000000020002010200010201000200000200010201010000000000020701000101010101000002020200060002000106000000000101000006010200020106010100010102010000060707010102010002020000
01010000010200010200000202010202000101020202020000010002000201000201020002000601020001010208020000020005010100000201010200010100000002020202020101070008010100000101000102020000020200020500000000010100
00000100070000080101020200010102000200020002020500020201020200060201070101010202070001000002020001020000000000020000000102020201010700010100000000020101020100020000020202020102000702000101060001010006
02010100020508010100010000050006020002000502010701020000000100020100020102020702020501010201010500000102000100010002010800000205020202020500010102000102020100010107000001010202020105010800020001020200
02010100060100020200020001000101010102000000020101020200020802010100020202010100080501020201020002020002020101010102000007020102020000010008050202020200010101060201020000010000010200010201010505000100
01000001000800020200020200000002010201000202070001000200000200010202010008020200010202080102000201020801020200020101000200000800020008020101020001080000000102020701010202020100020000010200020800000202
00020101010001070008020107070001020201020002010206020107020202000008000101010101020201010201000800020002010102000202010102020200000202070101000102010202010800020100000000020802010200020100010800010002
01010000020201010002050206010707050001010102010000020102010100020002020601060200000001010005020001010002010101010207000002000200010100020100000202020102000100020101020100010102010201080201000100010102
01020001020200020002010101020100010600020101010101010200000200010001010100010001020202070700080008020102000000000201010102010005000002020807000101000102000200070202020100020100000001020100010201000000
02020108020702020201020201020602010001000001000100020002010601000101010101000002060101010500000107020000010205010002010802020701000101000102000002000205000002010002000208010800000206020501010701000202
02000201020201020001020001010201020001020101020202020108010200060601000001020006020200000101000200020102060602050008000001080101000006020801020106060000020200080201080101020000010002070102000100050202
00020200000602000102010200010002000002050101000102010000000005000702000201020200000701020101020000000201020002020001000001020208020201010200010002000101060000020007020102020201000201000201000002020201
01000001000201000102010000010202020101060202000100000801080100020002020100010102020502010002010200000001080102020102000000010001050100010000010006010202050008020106000000000201000000000100000106000200
02010105010000020206020001000002000200010000010801010001010000020000000002020002000102050002010500020106020202020202000102060002010208020102020001020202000101020208010000000001020001010002000102020101
02020000020007070005000001020806020000000001020201020001000005000600020101070200000701020001020001010100010101000202000100050202020102020000010102010101010002020100020201010008000002050101010202000501
00010202000100020102000107020002020101020001010106000000000000010201010007020001010001020001020101000001010100000500010200010006010100000101000200010207010002010105020202010208010002020002020001020102
02020101050002010000020002020107010202000105000001010002060101020105020001010202020000010102000200000102020000020202000100020001000200010200000102000101000100000001020201000101010202000100020100050600
02010101020102010102010008050200010002000200000001010202020101000000000602070005000105000200000102020100010000070102010201000001020100060100010101000202020002020000020100000001010202000701000100010000
00000202080201000600020100020100020001010000000000020102000000000100000001010200000000010201010200050008010101010002070005010001000100070202020102010601000202020202000202010001020200010102000202020200
00020002020202020000020002000201010100010100020001000105010005070000000201070201010708000505010200000101000100050000000202050100020102020201010102010200010205020101000201010100000001020201010201020201
01070701020201020002010002010202010100010105010201010102010501010102020106020001000201000202020101020000020102020101000200010000000001020002020000010100010201000102020100000201000101020000060100000100
02000108020601020202010200020002020201010101020201010205000106070000000100000100000202020100010102000002010101010002020002000100010001020602020202010001020001010201000001010201020202020102020106060202
00000000020000000101000200010201070002020100020000020002000200010202020001020000010001010801000200010002020201000201000101000002010202020101010000000702000200010001000201010100000000010200010002000002
00000102020000020000010201000200010102020201010107020201000102050106020202000000020002010101010001000101010101020001000100010800020100020802020202020202010101000207060207010705000000020802000100010702
02010202020001000102080102000002000102020200000202010206020101020201010002070701000202010008010202010200020601010001010201010101000100020202000102020200020000000202010100010202000107080100010208020000
00020101010201010105010101020000020105020702000001000202010202010100000100010101000802010208020001010201020200020001010108080700020102010002010201020202020202000002010000000000010002000005000000010701
02010002000002000201080201010100020002010200010000020201000200010000070200070101020801010101010801000001000201010102000002010202020206000000010102050001000201010000020101000002000202000608000000020200
01020206020002020208000108020000010200010000000800000101010200010002020102020001000201020100010000000101000201020202000200010002060106010202010205020600010000000200020501020001000000010101020105080100
02020001020100000202000001010207020200010001000202010002000102010200010001000100010001020101010700010101010100000001020202000105050202010101010001020206020102020201020000020102010002010005010000000102
01010202010200050207000202000806010101070000020102010002010002010201010008050002000102000002020202010201020208010001010101010000020502010100000501060202020202000108000108010101000201060002010002020100
01010601000201020001000101000102010700020001000200020202010800020106010100010801010202070502010201010102010102010100050100000102020101000201070002020000010200020000000100010102000000020200020100000000
01010000010201020101050501000101070108020002020100020002000500010101000105010202000201020001000001060102010507020101000002010101000202020200010101020001020202010202050502010201010101000200020102010001
08020101000002020000050202010802000201010100010001000001000001020201000702020002010106010106000001000600000202000102000000000000010000000002000002010002000201010000000002060202020102010700000002020600
02020202000000010001020200020200000801000100000000010600000201010101000001010002020102000202020201020202050001000101070101080102010102010806000001020200010200020102070201020101010508020002000100000200
02010801010500000001020201020101010102010000050200070000000100050000010101020200020100080206010202000201010001010201000000000102050001060102060202000201000102020100000001010000000106010101000208020202
02020201020102000001010600000002010200000101080002000001010101020802000102010002010200010200020201000100020101020101020101060207010002010100060602020102000000000101020200020101020001000100010101010207
00000201010100010200050601010200000000020502020000020007000101020002010101020002020200060500010100000101000100020102010202020201000101010202020001000201020100000201000108010102000002000202000701000101
00020000060600020102020202010201020102020002020001010100020200000100000001000202000202010102010702000202000008060200010202020001020102070002010207020202070002080002020100020500020200000101010000020101
01020001010200010002000002020200010101010102070100020202060202020101010201000102010202020000000102010000000101020000000102010001000000010701000100000201000600020200010101010601020002020201000002020000
02020100000007010001020101000502020201010601000001020000010001060101060100010200020202010000010602080000010001010002010102050202020102020000000102010101010102060000010000000002010802010105020706000106
01000105020201020702000201020200020200070200000102060001000100000100020008020207080100010705000100000102000200020002000000000205000700000207020200010000080801010008010000020102010002010101020208020201
02060102000202010001000101070005010202010100010500080200020601020502020202020102010200020002010201020100000102000200000101010100020001010007010201000201020701000201010506000108020801020001000200010100
02020201000102000102050001000001070200000001010801020201070102020100000101010201020100020101010002010200020008060201060001010202000200020102020001020000020207080208000200010502020001080001000601010201
01000201000100000101020002000101000108000200010100010105020102020201020202000200080001000101000001000601010000010101010008020101020000000501000100060005010100020502010100020101000202010201010202020201
02000200000708020102000002010102010002020101060001000000010506010101020102010006020102020202080201020802000001000202000201010201000102000000000200000001020601000201000100000205010701010200050100020000
00010000000201000701000200020101020101010100020101080102010001070100000602020100020000020101000202010200000201010201060001060201010100010007000100000101020100050200020700010201020202020208010002020102
02000200000602010002010202000202000500010000010201010100000002080202010802010200000001020100010100010001010002020100000000020102010002010001000201000202050002070000010200020200010002000102010100010101
01000702000000050101010002010001010201000001010008010200010002000102010102000106020002010102020002000200020200000001020007000202000202020101000206010101020100020100020201020001020000000101020101000201
02000000080206000500010202020002000202010002020200000800010200000700000002010100010200020202010200020601020501000202010101010707000201020102000201010100000107010102000102010102010801020101010200000000
01000202000000010200010101010200010802010802010101000201020101000202050202010001000802020201000201050100010202020102000102000201010202080207020001000002060102000000000100000202010201010700050802020000
01080102020001070200000706010000020502050207020202000202000201010200000000010001000000000201020200060102020006020100000001010202000101000102010002020201000201010002000501000202010201020101000001020001
00010107010002020101000002000201020201000000010000080001020201020202000202000201010001000802000002010202000801010200000100070202020800020501020206020801010002000202000005010200000800020702010200000102
01000102010100070102020100000200020201000202020202020102020102000202020101020201020200010001000000020200020107080002020201010102020100010202010102010002010202060101000101000001000202010000020102020002
02000101000001070001060102010202000200050201000002000102010008080000060102010200000000000105000208010002020201060002000201000201020002000102020802020102010000000102010102010102020002000102000000010005
00020001000200080000010101020201020202020101010100020102020000010102060202020000000100000200020601000102010108000202050101000501020202070001000002010702050100010001020100000100010701080500000001020000
01010101010007000202000001010202020100000002000101010200010805000001000101020202010001000202020701020001020000020101020001010000050001010501010101010202020000080200020100020600010100000201020200010002
00000200010007000100010202000202010508000000020102020102020007020100000000020101020700010201020801020102000007010701010202000001010202050100000102010000020501000102020001020206010107020000010201020002
00020102010202020100000202020000000102020202020001070102060202010002000202020200000002000100010001010701010202070200020201010207000202010107060100000200000200000202010202020000010000010201010000020602
01020102000100010002000000010102020000000102000002020101020101000001010001020100010001020602000202060608000102000000000101000802020000020002000101010101060102010502000602010100000200000100010202080000
02020101020001000206020002010000020102010001000001000502010202010600010102010100020200000100020200020000020202000200020001000500060100050002020101020100010602000202020002000002020000010101020101020200
01000702010200000002020001000201010101020202020200010202020000020006000002060202010700020601020200020102000508020001000108000606020100000002080102000102020001010207010102010005000100000001000202070201
00010002000100000101010002000008010002020001060101000000060000000101010200020102020001000002000000020207000101010002060601010102010802060000000501060102000100000001000100020100020201010002020207020102
07000102020201000000010200000107010202020201000101000002050200010202000102080000010002010000010000020600020200010201020000020101000200070200020101010000020101010601000201020102010100020202070101020108
02000100000001070102010200020101010000020202020002010202000002000201050006070002010107000000000002000601010002010108020201010202020002060200010000000500020102000101000201010702010000010202020008080101
00020000020202010000000201000000000000010100000101010101000202000001010201020002000000010201000201000202010100000201010202020100010201020502000202010201000101000202010102020100000202070201000201020000
05070005010606020602010201020008080101010202000002020101020102010201000202000102060000070201010100000100000202010001020607020101020000010000010102000000010200010002000000000100010202050201020200020700
07010201000200020006000100000001000200010602020105080101020100020002020000010800010200010000000601020200010500010001020001010101070001010006010201010201010108000201010002060000010202020100000101010102
01000801000002000506000000000600000200080808000200050202020000010002000100010000010202010200010000020102020100000006010202020100020201010200020001000801000202020205010207020100010201000200010100000502
01010002020102000000010201020008020201010007000000020000070002010101000000020102000101010008000106020208000001020200000101050201000102060005010001020101010002000006000005010501020100020201000101010201
01020005010102010100010205000101020002010100000001000102060001010000000700010701010001050002010202010101000200000001000001000002000102020005020202050000000002000201010001020201010202070205000002000100
01020002050002010201080201000101020200010200000206010000010002020100050008010002010101010102000201010800020200000102010002010207020100000002010002020100010100000602020101050002000002070001010201020001
01010202000808000101020105000800010001000200020202000200000102060100000101060202010001000100000002010200020002010101000202010202020106010201010001080200010200010101000200020200080200010202020100000001
00010000000000020202010700000000000101080200000100080001020201010000020105010201010202000002020205020202000202010001020100020102000000010201020001050001010201000700020200000002020200010202010101000102
00010102020001010200000100010200000101010202010100000101060001020001000005000001020002010102020002000202010000000001000000000108080000020000010200010101020102010101020000010002020202000106020000020102
02010200020006000105010802000202000202020200010105010102010101010202010102020202010201020101010202020500000102020101000100000101010001000205020106020201020102080606000100080000010102060200000101000100
