01000100050001000101000005010002020701010102010001020202080200000001000100000008010802020701000202050201000001020801010000020101080201000102080101020200000006010200060802000200010201010201010102000202
02060202020600000101070600060507020201010002010201020200000100010001000101070200020002000107000001020102010002000202020102080002010201020201060102010202000000010000000200010001000001000201020201020501
00000000000102010008010002000101020601020100010100000102010002010001000100000201020601020001000102020200020802020100020002020201020800010100010200010200010000000102000202080101020101000005010002000101
00000202010002020101010601020202000000020001020102010107020802000200010202010800010102010101020102010001080001080000020801010201010102000107000102000200020200000700020008020202020100020201000002000001
08020101000001000200080200070100010001010801070200000106000800080000010005010202010206080001020108000101010002020102000001000100010201020607000001000008010200020001020101020701020206080100000200020002
07010201020801020202020202010102000102010007020200010201020100020002020700020101020001020006010100080100010202010001020000000006020002000002000202020002020101010201000202020102060001020102020100020202
00060601010200020202000202010201010500010200020202010000000002050007000102000200020202010100020200000002000001000200020102020002000002000002000000010002000101000100070002020208010000000702000600000001
00070006010102000001010200010002020202080100010001020101000100020200020201010201000102020501010500000000000608000200020001010201020201000002000100010201020102000006060202010107000100000008060001010208
01020100020100050102000100000802000000080102020106000201000002000202000000010001000100020007010102010202010102020001000202020002000200010201020002070701000001020105000201000201000001010107000202010201
01010000010100010001060000020101000000000002000002000102010200000101080002050002020200010101020800060202000202050106000002020201000202070201080105080102010801000002020100010205060205020108010200020200
00020100010202010102010205020601020200060201010100000001060200010102060801000000000100020002000001010101020102020102010200020000020202000200050005000100010000020001000801010200000200000007020101080001
01020001000005010101010200020101010800010101020000000200000201010500000202000201010001020200000108010000010602020001020002000001010001020700000802000105000200000002020202010201020001020201020208020201
05010006070002010206000000010101050100020000020202070201010202000007000605080000020801000200000108000000000000020002020201000007020101020102010202020808020702010202010100070000000201010000020202000002
01000202010201020100020101000200050102020002020002010201010201020102020208010201020202000002020000020202000801020202020202000201000100020002000808020002010100020008010101060100060101020000000000010702
00050001060200010201020002000700010107020100020101000001020505010002000100060200000205000001020600020207000100020201010101010001010201010800010000020102010808020700010200020102000802070108010200060000
01010102010002000001000000000102010100010102020005000200020000000100010000010002020200020002010802020001020000010102000202000100020102010200010001010002010002010000010001020100010802010001010101020000
01000202010000000102020000010801020000000000000502020107000002000000010100010205000107020000070102010000010002020100020601000201020101020208070200020002000106010205020200020000000501020001080002020005
00010101010007010200000200020202020001060100020001010002010702050205020002000101020202010100020206070200000200000201000102000102020008000001000001020201010001000000010001020100020201020000020200010800
00010000000202000202000601000800000002050201020701020202020108000000000001000101000002010000010002010100020800000101010802020101020202050200060702020102020201000102000202020602000102000101010102010205
02000001010001010001010000020506070200000002020001060200010201010100080002000501010001020000010100020102000202000201020000010700000107010001020801020102010102020101080200000802000201010000010202010001
02000200010002000201080001020007020207020102000101020201010608020201070100020100010002020000000000060102010000020101000200000005010100000200020005020000000701060102020201020001020102000201070101010201
02000802010202000102010101020101010101000002010201010101010101000100000200000000000101000201020801010200020106000102010201050001010102020200020100000102000601020202020202000202010202010102010105020202
00000000000102010000000200020101010202010000010101010201070100000200000001000208000500000000010200000200050002020001000101020000060100020101020101000502020102020200000602020100020001020101020202010200
01010100000202020502010101010001010102020100000101000102010002020000020102000101010102000106010201000001010201010201070100000100010800080002000108000102000702000200000102020201020602020800080601020102
02010208060100000501020600000502000201010501010800010207000202020001010001080202070001020002010701000201000000020001060101020102000101010102000002010000010001020002000100020002010201020200010200010101
01000102000002020000000707010108080102010002050100000000000202020201000002010207020205000200050200010102000201020101000501000002000201000201000802010002010201010101000002020202060106000101010001010201
01020202010201010702020008020105000200000000000101020202000208000108020201010200010200010201020101010000010101000202010102010101010601020201020002000102010001020200000002020101020002010201000102000101
01010602010000020200000001000101020100020602000001010101010200020001010105000100050002000001000001010200000202010200000102000000010106010100010205020201020201020202010201020000020102020200000607020201
01020200020600000202010101010000020001010201020807000000020102000100010202000202020601020501020202020000020002000101020000020201020200010102020205020000020002010002020202050201020002000101010801000202
02000201020101000002020000060101010002000002000000000001010001020206020101020200000202000100010201000802020006020000020200000806000202010200010201020001020101020000060101020002000600080108010101010202
01020201010202010202000001000001020006020201010202010201010000010005020000000002020202000201010200060001020202010000020102010802010201000002010100020801000001010100050601010000060000000000010000000001
08020202020202070200060002000002010100010200020601020101000000010101020102000206010201010101000102020108020202000200010000020102050202020102010107010206010002010100080200000200020202010100000500000100
02020100020202010201020000020000000202000000010200010001060000000100010707020200070100020000010101000202010205020202070100020001010100010802010102080200020000010207010001010802010602010501000201020201
00010001010001020200020700000000080000070100020000010000010102000201000101020202020100080002000202010101010101000601010000050202020501000206000000020000010201000206010201010202020000000100070002020202
00000107000100010201010200010701020100000200020000000200000102020101020102020002020102020200000200010101060101020201020207010001020202020500020006020002000001020100020100010202050001010001000101010001
01010101020201080207050201000200000000010001000101000202020102010000020201010202010201000202000100000001020002020001010100050000020500020201010001010108010000070002000801080202070200000002000101000101
00000201020200000000000700000008020001010100000102020200080202080100020100010102020700000000000001000101010008060002000000000202000201000000000201000102010202000201080200000000020202000100020206000000
02010001020001010201000501020100020201010700020001020102020100010001000201010100010200020202020201020108000001020201020200010002000102000000010607050002010802010102010002020101000200000002010600080002
00000202000101020101000002000102000000000002010105080000070001010001020100020000010101020102020002000601010000020100080100000101000202020201050102010102020200000101010102020101000201000102000100080100
02000202020100020001010101020002060100000707080100000202000100010005070201010601050108000002010102020200070000020200000001010202070202000000000000000202020102020201020000000100010002000200070006060102
02050200000002020000020202080201000100000000010200010100000201010105000105050102000102000000020201000102060208010001010102060102020001000101000700020100020102020105000200010200000202020000010102020100
01060102010102000001000201000000000001010202020002020000010502010101020202020000020001010201000108000101000201020701020007000101020101020207020101020702020000000102020200000001020002010100010101000201
01010602020201010600020000020500020101020100000100000102000202010101000802010102000002010102000002020201020102000101020200010002080200020701000201000001020101010002000001000200020001000101020202000101
02020200020001000000000000020101020705080002010001010200020207000702010101000000010006010102000101020200020208010001000100050102020100000002000202010001010101020100080001020201010001020202010102060100
01020201020002060001010101010600000001010101000100020600020006000000020200000000020005020200020201080108020800010200010101000000000002020102010100010100010206010206000100080202010101020202080202070202
00010000000100000200010201000102020201010200000001010100020002020006020202020100010801010702020101020707060001010202020000020202080105080101010506000000070002070205000000020002000100010002000200020102
02010000020201010201000100050200020101000102020201000100010101010102000200000701020101020202020000050001000002020001010202010202000200020802010202010001010200000007010102010105010207060207020202010201
00070202010201020202060200020000020002000101000801080001000200000100000201080101020202020001020201020001010107010106010006010201010000000002010001020100010002010101000201060101050008010100020200010101
02010101020202010005000000010000010202020800020802010101010101020201010001020801010200000100010000050202000002020101020100010200020101000705020201010000000800000100010102020002020002000200060100010106
00020100010100020008010202020000020206010101020000070007000008020201020202020102020200020200080702020100000001010200010002010005020100010105000006000202020200020201000102010602020201070100010001000001
02020001000101070000070106010100010002010000050800010000010100020202050201020000010102020102000202000002010101010001010202000500010201000202010700000200020000010102020105020101010200020201010002010100
01000201020101010100000102010208020100010201010102010107020000050101020201010100010202020101020002000002000102020208010201020207020000000006010201010101010202020202010102010202000102020202020102060002
00000100010001000000000205070000060002010106000101050200020200020202010708020002020800010701020100000001010202010007010002010102000002020202010002020200000602000102020001020102010100020202080100010002
00000200070101020701020200020101010801010201010201020108020002020100020001020000010000020200000800020000020801020100020202010100010500080800020802020700010100020008000001000002000107020102010202010000
02000202020002020002000002010002010200000200000000020101000200010002000002020100000201020202010102000001000101020100050201020201020101010201010200020107020202000200010001000201010102010000010000000100
07000000010101080202000001070008000001000206010502060102010202020101000101080101010202010102020200010000010800020201000200010101020200010501010801000102010102020002070102000200010100010105020100010100
05010102010000060000010002020101010000010100000601010201000102000201080100020100010201000200020101000102010002010202000102020100010207000200000102020001070000060001000201060001000002060801020202000002
00000102000202000100020600020200020001010006010202000008000007020100010002000601050002020001020200000001000502010000070000000205010008020200000001020102000200060502010000000101060202020000050002010205
01010200010200020000020102020800000701000201010100020001010101010101010601020002010100010101010201010008070200000107070002010202010101020002020201050002080102000201020201080202020100020202020102000602
00000105010202010006000000070202010101000200000201020201010102050102020002010001010202080200020108020001000102020001000701010100000202010501020601010202000202010200010200010202060102000001000002060208
02000001050106010201010100020200010001010200060200010102010802020000020002010102020200000201000200000202050502000202000101020100010201000102020001020100020000080205020107010105020102020201020001010707
00010200010001000101020001010202000100010207010002020500020607020000020001010102000101010202010102010207010001020101020201000000020007020101010001010000010102010201010202000100020100000101000000010102
06010102020102020107000800010801020000060206010101010208000200020000080001010002000100010102010101020000070202010100020100000100020200020202000101020001020100000102020102020102010200000200020102000101
01080202010001060202000101010102000101010201020200020200020600000002000001000002010200020200020201010102020000010001000200020001000202010002000101000101020000020002010100080102000006010000010100000002
02020008050001020100010000070008000201010101000202020102020001000000010001010100010000000102000202010206010002020100020801010002020000000102020000020100010001000102020001000002050002020606020200060001
02020001010002010202000101010100020102060000000101000502020102080002020001000102060205080001010107020005010102020002010008000100000100080800000602020002000000020101000200010000000101000205000107020702
05010207000101020102000001020101020102010201000002000102000201000000010100020106020202000001060200000106020201010102020802000100010202000007020200000002010201020101050202020105000102020001020201010002
07010201000102010001000100000002000200000100010005020200020101000101010708010100000600020100010202000702020101050100010101050005000100010100010601060200020102010100000101000202000002010200010607010600
01000201020202000101020002060002010002020200020105000200020001010102020002000100000108000100000207000101000102010102010205020100000001010001020200000100010102010002020105080202000100010002020101010205
00000202000002000101000201010002060201010000010202010000000202010800070102010000000100010202020000000202020202000101020201010001020208000102020107000002010700000800000102010001010102010000000001010201
00010102020202000000020208010102010200080100020000020201050800020001020000000102000002010002000201000000020100000102010001020100000200000002020102000001010002010602000101060202010000010200000202010102
00010001010206020000080100020201020200020000020002020202020002010102050601000202000002070200050102000101020202000201020100000202020601010001010001000200020500000806020202070200020005000001000200010002
02010001010101020000000202010100000102010208010002020001010102020801010201000007000205000002000200010200050101000202050200000002020200020000080202000200020201020100010101010102020102020001000102000002
01020000000501000208010000010102010202010100010001020008020102020202020207000202000002020102020002000108010102000606020200000200020101010002020002010102010200020000000100010100000201000100020002000801
01010101010200020202010200000002010202000205010202020000010000010000020000010100010001010500070002010207020102020205010506010100020002010100020100010202020601000105020000020200050101000000020501000601
02010200010000000101010000000506000602000201010202010102000200000200000102010200010100020802020200000200020106080200020202010702020100020108080101010002000702020702000100010102010105000502000101020200
01020201010201020108000200020000070201000202070000010802020102050002000000010201010001020002080201010200020001010000000202020208080102010000000001000206000000020202010000020000060202010202000201010000
01000100010201000000080001000205020002010000080200000002010200020008000000010806010002050102010107020202010201000200010000020201060201010802010005020200000602020002000102020101020200000201010000010600
00010000020000000202000000020101010100020201010202020000010102020701000201020600000201020201050000000000000201010100010101000002000000010800020200080000060201020002010100000000020202010001000501020201
02020202010101000100010201010002000602000100050100020002000001060201020105070100010002010101020100020100010002020001010002010000000002010102020101060101000701010700000000070002010006000102020702000801
02010801050202020600000102010102020200020005050200010102000101010806020201010101020202010201000000020102000202010102060208010207020001000001070200010200010102070202010001000201010800010101000000010101
00010002020101010106000000020102010000020002020000000202010106000100080002000202010200070006010100020101000106000006010002010100080002010801000100000202070102050200010100010001020000010205010201020001
02000200020007020202020007000200000100010101020100000002020002010000010000010100020000000200020801000702010106020202000002010101020801010202000202000101010108010201000202000000020002000001000002000000
00020502020001020000010102000101020101010007000201000101000202010102000201000100050102000000020005000200000001010202020000010101050201020100010506010105000108010702070202020100010602000202010002020000
01020200010101020002010002000202010100020101010201020002010002010202020002000101000008000208020108050200020200000102000101080102010201000002020102010000010201070002010100000801020107010201020200020102
01020602010200020000010206000002000206050201000601000200020200020202010805020206020201010200020200000102010202010202060006010001000001000107020000010502000201000200010201010100010100020605020200000100
00050100010102000100000001000106000001010801010100020100010202020100000101000101020002020001000702010700010202000102020101000002000002020201020002000001000101070102000105020501000002010101000705020001
01020001010102020101010100020208000205010000020201020202000001020100080001020202020106010002010201000800000100000001020200020101000201000200010000010102010202000000000201060201010105020100000200000107
02020001020502020102020602010105000000000000010102020100020001020001020702020201010200020102020101010001010600010105010801010000060001010002010102020102000000010101010001010202010701010002000200000200
01000201060000010002080202010001020100010201050002020101020100000200020002050202010500020002000101020200000002000102000108010201070001000201020200010000010200000100010101000202000602000102000202020101
05010201010102010000020002020101000006020201020208010101010000010000020002020102000100060207010000010002000200050001020102010700010205010200000002080005020006010101010002010200010002020707020108010202
01020100020207000701000000010202000102000102020001020100020101000600010101020202000201000001000100020201020102020002000102000002000202000001010205000000000200020007000001010202020002020202010202000002
05010000010201010502000200000107000101020002020202080001000001000000020102010000010001010100010202080202000000000100010201020200010001010501050202020000000101020001010000000002020201000602020101010000
01000100020200020102000102020101000001000200000800000001020000020101010201010706010200010602000201020201010102010000020201000101020100010201010201000200010102000202020202000201000208010001010200010101
01000106010101000001020000050200000202010102020200000102070001000201010100000000010000010000020006020100000201000000020100020000070500020201010100000000010201010201010100000700010000020102000101080202
02000002020001010501020102000001000601050202000001010102020208000200000006010102020001010008000201080200010000020706010000000200010102010205010001020802000200060200010105010200080100020201020002020002
00000001010101020802020202020200070602000207000202020101000200010102020000020202060200020101010102020008020201000101070200000001010002020201010200020100010201020801070101000001020201010501010202020801
01010001000001000000010101000002020005020700010205020000020102020000020200000002050100020802000000020202010100050000000201020000020101010200000800010200010001020101020207020202010001000201020100000101
02020200000105010102000201000101020101010102010102000107000200000000020000020001010201010608010001010200050200010100020002020500070002010200010006010202020200000002020100020202000202020208020100000002
02020006010000010002000102000001000000020202020101000102010002010201020102020005000005050101020100010008000005000200020200010002010201020001000201060200000007000201000101000202010002020100000101000100
