00000002060201010200010100000202000000010100010107050700020001050200020001000100000001020202010100010200000801020101020001020601000202020202020101000100020101010108020000010201000100010201020102010000
02080002000002000102020102010102000202020201000200010000020001010000080100010101010001000100000101010102010002010100010802020002010000000100010800000002020202000102010102000100020000020202010201020202
01000002010001020206010001060000020102000001020202010100000800000201020801060008000200010201020200060002010605020001050202010102010001010100000000020202000201000201000101010000010202050001000100010002
00010805000002010201000002020202070102010202020202020002010602010101010001000102010202020201010200000100000800020102000001010102000002010007010101020702010000020202020102000001000001010800000000060201
00020502010001060101070001000002000201070000010200000101010007010102000102020201000802010600020800020200020100020100020206000202010101020100000500020001000001010005000000000002000002000500020001010100
02010201000005000202010001020000020200010100020100010006010100010800020102010501020101020101010208010007000002060201000101020000020202010001000001060205000202010001010101000102020102000002020102010201
00020200000200010208010200000001000000010201000100010105020102000000000601000201020002010001020602010202010601080701010000010001070802000201000002010001020102050102010100010202060008020000070202010100
00010100010000080002000502020702010801020000020202010202020002020002020100020100010001010101020001000100010002080201000008000000020100010002010100010000010100000208020201000608000008000101000000010001
00020201000101020002020001060002050002020002000207010107000001010202010002020200010102010001000001000100010201000101000100020000010108000202010101060101000002050702020002010002000201020200020701000001
02020205020002020100070200070200000000010001020102000200020501010200000001020000020000000002000002020101000007000505000102020200000102010202020006010800020700020200020007010200000002010100020002000101
02010002020202000701000101020002000000070208000100020002000202010100000100020100010501000200000001020101010001020101020601010800020100020102000202000000010001000200020202020001050000020200000100020202
01000502010205010000010101000200000001020001000100010102010201000208020002010201010102020100000200000100020108010200000000020600020102000000020202000207020200010002010200000001050002020000010201020001
02020206010100010100000100000205000006010001010201010200020101020201010202070100010201010100000008000101020102020600020205000201020000000201000100020001000102020005000600010702010701010205020100020102
00010208000201000100020000010102010100010200000001080200000101000000020001020200020205010201010002010001000700000200020201010000020200000002000202020002000200020001010202000802010102010101000102000102
08020201020100000002000200020000010601060000010202000201010007020101010102020102000200020202020000000001000000010202000801000107020208000200020002020102000002010102000002010102010001020600010000000002
01080700000100000007050001010100000100000201010107020101000100080002000200010207010202000100020100010102020002020501000200010101020201020008010102070001010000020000020201060000010202000100020202000102
08020101000102000102020000000001020001000200010100020002010201000001020002020602020708000102000202010001000202050000000002020001000201010101060001010101020200010201000800020501050202010100000201000001
01020102080002000605010001080101020002000002000801000002010100000101020002000201020206020102020100000102010001020007000200050201060101010000020502010601020101010501020201010102020202000102020100080201
01000002010101020100010100000002000701010201020100010001010101060100020000010100010201020201010006010105010000000200020100010000020100010206020200000202020002010000060501010001020002010208070000010108
00010200000202020000020208010100020102010101010201000102000202000200000101000202000100000002010100000107050601020100080001000000000001000205010201000007010508010001080206020101010100020101020001010808
02020201010000000107020107020201000002020102010000000801050100020102020007020000000201010002010001000001020005020001000200000200010202010202080200000000060102000200080200020600000201010000080501020101
01080202010701070600010100020001010706010000020101010000000200010102020101020100020100020102000201000200010602020102010100000001000100000100010001000102010602010102010001000201000001020500020102000200
01000501020202000007000200020202010102020201020101010001060001020005010100010101010708060202010102020101000000070100000100020202020202000000000200000102000201020100020101000102000101010001010001020200
07020202060000010100000000070201060801010002010100020006010200050102010502000202050002000700020100010102010000070002000002010107010200050102020101000500020001000001000002000002000201010507010002010101
06010202010001020101010000000102010101010000020100020102070100080208020002020102020001010101050001000100020002010102020705000002020601000201000000000000020202050001010001010207020001020101020002020002
02020101010201000101020002020002000000000101060100000001000701010102000102010001000101020001020100000000000102000201020001000001000200020100020002000200020002000001000200020201060802010000020102000200
02010102020000000008020002010200010200020000000202010700010500000101000100000501010802000102020002010202000100000200020100000001010002000202010207050200010100000202020001000000000607000100000100010101
01010802010000010001010702010002020002000002020100000000000005000201020101010202010001000000000002020201020200010001020002000002000000000008010001020801000202010101000001000600020102000202070200010000
00010602080200000002020801010001000102010001010101050201010101010008010100050100020102000100000102020101010106000107020200000001020002010201020000000100010702010201000102010002020002060202010505010100
00020202000201010000010002010201010002020001010000020000000207000201080801060100000102070002010200010200020100020000020201010501070000020100000200000001010101000108000700000101000102000008010202020000
01020200010101000201000001000201070001000001060201010100010601020002070706060501080102000208020101010501020001010102020200010101010601000808020000050101050001020100000006000201000706010201020101000100
01000002020101000200010200010202000001020000010001000200020001080000010201050201000001010202000101000701020002010201010002010201010001020000010202000102020000010201010101010201010600020207000100020200
02010101010200080602050007020102020200010001060101000100020102020601020201010000080500010200010201000200020001000101050200020101020101020001080200000200020201000202050100000202000201020000020201060000
00000501020002010002070000000200010002010602010000010002000001010002020101010101070001020001050202000202000102010201010101020600010202010002020701020200000100050201020001020102000202000002000001060202
02000200020200010208020101000102000201000002020002000102010201010200010202010205080000020202070100070200020000010002010200000802010101010101010100020002000202010002010202000701000107000001010000010002
01000502000202020001010006020100020200020802020008050000010002010201010202080201070108000502010000000101020001000002010002000701020100010102000000060101000101020200000602000102010202020002010800000201
02000001010202050200070100010100020001010201000201000005010200000000070202020202020802010202020101010100020102010101000200020601070700000202000002020002000202000202020100000101010002000001010802000105
01000101000002020001010102000002020000020100050200000101010202010002010202050201080002010000080001020200000602000200020000010702020200000000010701000202000200070100000102020100000101000202020100020100
00000202000000000100020101020007010002010201010201000200010200010100020205020200010000020202010101010102000000010606020001000200020006010202010101010001060100000200020100000100000201020201080202020100
00070501020201010200000701010200010500000001010102010100010001010002020000020202000501000002010202000100000200060102050001010200010100000201020702010101020202010000000102010101020201080501020002000500
01020702020000010202010208010202020101020001010502020201010201020201020002020200000201000000060201080000000202000201020202020201060100000100000005070102020001010200020100010202070202010200010002010200
01070107020202050201000200020100020101010100010502000601010100070102050501010202020202000002000007020002020008010000010202010102000002010200010000010200010000020001010005020100020107060107010200020100
00010202010001070802000201060002010100020200000201000700020600000201020201000108020101060202020201010000080202020501000202010702010208060001010001020001020201010202010201010201000101010105020102020200
02020200000201020601020102010001010202020202000101010001020102010200010202020100010102000100050200000101020200020101010200000002000201000102010201080100010102000200000106000202000000020500010201020201
01000000000101010206020602010102000000020002000002000202000000000201060101010001010107020202020108020100000202010100020100020000010101000002060202010105020102010700010002070200020501020101000200000208
02000102070100020200000102000601020002010701020201010102020206050001010001010206000200020002000001000702010202010700010002010000000000000202020002060202000201020002000200020101010101010202010000000106
08000201000201000102020102010700010102020201020002020101020002000500000200020000020200000702020002020002050201000100060001020002000100020202050202020702020202000006020102010002020002010002020707010101
02070200010208020001020201020201010201010201020502020201000602010007020200010000000002020102000200000200000007010802000202000202080802010200000201020001010207000100020106010001000700010000000202010102
02020001000200020201010202070001020801020200010100010102070000010001020002050208010000020101010102010100000107020000010101020101000002000102020101020100000100000201000101010201010105010000020601010201
02010105000202010102060202020201000100020102000200020102010000020000050101000000020000010002020502010100020200010802010000020705020702020201000001020207000100000000000000020101020208010002020102010200
00010002010200020201010701020101010500020100060200000702010002010101070001000101020000010000020000000100000000000102020001010207000106020508000200020101070102010100020201020001020108000002020801070200
01010102000005000701000101010102000200000601000700010001010001020202020101080201010105010201020701050200020201010002000100000101070201050002070201010000010002000202020100010202020700010202000700000002
08010001010202020201000702020200000200020208010207000201020008020801000000000207020001020002020200000100010201010102000201000002000602060201000100010200020101080801000100000101020100000000000000010001
01020000000508020201010100010101010100000102020006080001050002000101000101000500020002000001020205010206010202010201060502010201020202020000010001020101010102020000020000020800020501010002020100020002
01000101020001000101010002000001020207010001020002020101020700020200010800010201000000020102080001010200050101000101000202010002020101000102000100020201020001010102070201010002000200000201010702020002
00050202020101020002020202000202010102000200010800000000020102000601020801000002020700000001080002020002010002010801000602010100020201000201010707020102020100000001020100010000020000000100010002010201
02000100010100000200000101050002020100020202010105010001000001080501010200010006000201000007010102000000000502020801000202010201010201000002020000020100070002070002010202010002000102020102000202000002
00000100000702020207000000020201050102010701000200000102010101010102010101020802000001000202000102010202010100000001000002020000020701010102000202010101020202010602010101020008020002020102000201020002
00000601010202020207010002010201020101000202020200020101000002000100010001000101010100010002010001020600010008010006020002020001010000010101020800020102010000010202000005000100020002080506000101000102
00020002080101010500000201070200000208010001020002020005010102020802010201020005010000010101000102010201050102060001010207000002020000000000000000000200000102010002020002010702020200010500010201070202
01020107020102020500010702000001020202010002010001010600020105000201010202000101020201020001010200050207080201010001010102020501000201010000020201020102070201020002000201020102000101010101000000000000
02020500000000020200010201050001060000000102010002010201010702010201020202020002000102010202010002020207020800000101020700010201070201000200020600010201020202010001000005020002020100010202000802050001
01070002020006000502010108010002020001020201020200010101000200010501010601000202080101010202000102000108000100000100020208010002000700010002010000010006020000010500020200020007000201020201020102000005
02010102020202000201000100000002010501020205000101010202000102010202000002010202010001020205000100010202020500050000000202000802010200020200020001000200010201080001000000000101020201010101010102000000
02000102000101010000000200000001010602000200010201080100020002020100070202000002080100000101020602080202010001080100080102020002050102010002010102020102010101000102010100020005000100020101000200020102
06050200010001060000000202080102020201020001010100010100020700010008010100000000000100010202020102010800020200000001020002010100020102020200000202010700020001010002010702010700010202000102020501010600
02000101000202000000020701020502050202010700000202020606010201020101010206020200010001020201000100010000020700010200060100000002020100000100050102020201000000020200010100000105000001000106000802010202
00020101010000020101010002020101010800020101060208010101020102010202010200010007070201020102000200010000000006010107000600020201000002000101000000010101020108020200000002010200010201050201020701080001
02020000010200010002020202000100020200000201050000080002010206010101020500080500010500010502020100010100060807080102020206010002000100010201020001010002000202010202000201000002010201010000020200000102
08020100010001000100010001010002000200010101020000000200020102010200070101020602020200020100000501010200010802020100000000000001010102010201070702020000000100010101070202010002000100010102000101010200
00000200000200020201010108000001000101000601000202020808000102020001020202000100010202020000020007000202010202020000020102010100010806000500000101050200070202020100050001010201000102020101050102000202
00020202010100020002020000080000020001000501010100020101020200020000020102010000010602070102000001070100010100000502020001050105020105000700020201000602000002010101070100050800020001000100010200000000
00020202000202010802000100070000010000010002000801020201010102010200000100010002020001000001020202010802000101000001020202010202000100000008010202000201000200020000020202020102020102010002020201010002
01010102000000000201010200020001000102010001070000010200010002070201000100020200000702000002070200010100010100020202020102010002020105000500010001010100020000010107010000000802000101000107000102000005
00000001000005000107020006000002020600020001020100050201020000010000000006000808010001000105010001000101000001000102000000000000000000020200010101020000000705000002010202020100060000050002020502000002
00020000000000010100020200020201010200000100020205010102010002010101000200000005010101050201020000000001000101000202000602010101010008020201010002020002070100020001020001000202010202010002020200010206
02000000020102020100000200010002010202020002000001010101070201000007000000000000010100020002010201000100020002000101010801010200010605010201020100010201020200020006010101010101020201080002010200020202
00060000010107020200010102000505010207000006010102000000000000010002000200010202010000050000010200010107070102000101020000020200020200000202070002000101010101000002010102010201010201000200000808000200
02010200020002050102010008010100060108010002010002010502080802000006010000000102020108020200020200000002000201010002000000010102020200020202000102020602020201000100000006010806010202000001080102010002
07020200000101000202000202020000000102020100020102000001050102000101000200000002000102010002020202020002020000020100020202000000000101070100010201000602000201000200050000060000020100020202010202000100
01010001000801020002010100000202020202000202010100000002080001000801010101020100000001060202070000000000000201050101000101020102020102020101020002080208010200020200000000020202020100000006000002010200
07000200000001070501000101000201010101060100010201010002010101020000000207010202020101010001020200020102020101020002010006010200010100080708000200000000000102020200020102020100050200020502000000000102
02000000010101010101010801020202010201010200020001010200010202020208020102000001010008020100060200000100000101000207000000000001050002020502010102000101020002010200010208000005020101020007000201000105
02010100010001000100020205020202000506010002010200010000070200020207010602020206010202010801000001020202050107000000010000000202000201010008020102000102020002020702020202010000010100050101000102000202
00010200020205000500070201020102020802020000010200010100010002020201000100020602020101010002010202010102020101000002000001000207010105000100010002000100010101000007000200010101010801020002010201070202
00020100010206010200000201000000020002010001010007020201020001000200010201000202000001010102020108010701000000010000000100050001000200020000000102000201020000000002000002010002020002010102020000010200
01060000010000020102010202000201000202000000020002010101020000010000000200000200020101020202000600000100010002010201000100070201000101000201000101020100010002000000020102020200020202010002020002010502
02020202010002010100010101020002000000010000020102000000010100020107020000050201020008010202000102000102010602020000020001000100000101000001010201000201010802010002000201010205020201000201000801010100
00010200020202080000020200010006010201000000000000020208010200000102080001000201010802010002010100010002000101000100020102080002000101050602060002000002020101010200020201000200000001000008020102050001
00000000010102000102020002000100000201010202020102020202000102050001000000000500020008000802010101000600000201050201010606010001010100020002010202000001010200010002010102000201000101020202020201000001
01020000010102010001010202010702020607020600010002020101000101020102080101000001000200010100050100010201020100010101020101000101010000000000020000000005000500000107020002020002020001060100020100000201
02020500010102010002000002010100020101010001020200020000020101020208000200010101050202010000010000020002080107010201000000010001000800010200000801020201010201020001000200000101010100020801000102010200
00010101020207010201000100020207010101020200020000020005000001010008010001020201000102020100060002000000010002000000000106010702080000010101000101000202010201000102020106000000000007000001000100000002
01020201000201020501000002020101010201000001010202070002020201020102000008020202000200020000020106010101010205070201010006010001020101000202000000010201000102010000020702020101070701020002000702000000
00020205000101010000020200020100070002020200000102020501010002010002020002020201000202020202020800000205020200000201010001000100010201020002020200000206010201000201010200010001020800050202010001010002
01010005020101000202010702050000020102010207000502000202070001000001000102020001000702010807010701020201010800020001020206010205020200010100010202020208000201010002000001010102020102010000020200000005
01010201020000020207010200000200010001010201020102000108000200010101000202010000020202000201000102020000010001010201000102020001000100050001020002000102020105010201010002000100010005000001020000010602
01020001010000020200010600000002060201000000000102010100080000020101010202020001070208000102010100020200020000010000000701000100050201000100020001000000000001010000000000020100020101010702010000000100
01010201000200000100000101000100000002020001010201000202000100000201020101010101010502020106020101080001010202010200000807020102020001010002020001060100020101010500020102000207020202020502000201060001
06020101000002020000010000010002000105010101000108000001000200020202020700010001000100000100020001010202010800020000010101000602000201000000000108010101020202000002020000080700000208000001010102010101
