01000100050202080100070002020001010201000000000201020001020101000102000002020000060200000102000001010006020100010001000102010100000002000107000101010100010101010100050601020202020206020207020002020100
01000200000000000202010102010200010000020202010101010206050102060100010202080007020102020100020201010001010000020006010200010100000102020000080202020602010005000000010100000001000108020005020201010101
02020601080200000101000102020202000101000001000001010102000100020201020202050605020001010006020201010202000102010002010101020001010201010101010202000102020100000202020002010200050001020101000001010201
05010202010101000105020208000802000102010002010000020601080100010502000102000200000001010101020208020001010101010002000100000502080206000202000200020202000601050100060200070200000001000801050701010202
01020000020000000207000102010200000101010102000801000000000201050200020201020200000700020101000702010102010201020200020100000006010106000202020001080002010002010100010200010101060101000200020200020102
01020202010201000102000200000002010000000002010201010000020100010101000201000201020101020201020100010200010001020205000000000202000001010101020802020002010102020000020102000001070002020102000202020100
02010600010201020200050101080101000600010202080205000501000100010000010102080002010100010101000008000702000201000001000200000000020100070208000101000002020200010100020200010002000501000106020602020000
01020102000500020201010100000002020001020002010200080000010201010000010701000700010500020001020801000002020106050102010100010000010702020108000001020207010202010500010101060002020201020506010201020001
00000002060002020108010007020102020101020001010201050001000201000000010201020201000601010201000001000100010106010000020002000002000102010100020100010001060501010100010106020201010001010000000200020108
08020102000100010100010101020100020100010202080200020101080001000201020100000202010107000102010102020101020101000205000002020201020001020201010200000102010101000200000100000202080200020200070501000100
01010200020001020002070102060000020600000001000101000102010101070207000202020002000100010007000100010101000102010208010100020202000101020101000200020802010000020102010700020101000201000200080202010001
01020202000202010700020201070102020500000102020102000101010100010801000101000201080106020202070800020101010201010200020801020101000001010206020200010202020800000001010102010108000101010202010101010200
01060000080202010700010100010200020101020102010102050000000500020102020002000000000000020201020201010101020000020107070200010007010000020000020506020001000200020100020202020100010006010100000101000001
02010002010001000001010100000100000102010201020801010000000001020002010002080200020100010000020208010000020001000102000002020100020100000201010102010002020100000202010702000101010101070000000006010101
00020002080102000501020001010107020102010202010102020500020201010100010202000108000200010100020000020101010102020001020102000700010200010000010101000205020000000501020208010000010200000802020102010200
02000101010201050200050202000100000001010001000008020102000200010101010602010702000200010200010102010207000000010002070800020101020008010500010201020202010001010101020105010000000101010001010200020105
01010702000102000001000102020001000102020000000105010100010201010000000100010100010100070202010002010101000001010002000202000100010001010001010101000000000100060001010001010101080101000101000202020806
01000001000002020101010102000008020001020200020101020201060001010108020001000701020100020101020101020100020000020000020201010001010102000100020002010001000102020000020001010202000000020502010100020200
00020102020101010102010802000102050000000202000202000100000106020101010200010200000102070201000102000000010700020102000201000201020201050200010005020107000002010000010001010501000100060102020202010201
05010200020100020106020001020102000202010502010201020202000202000101010202000001010101050606000006020102020001020000000105000101000000010002000200020102000202020000020002020202010201000101000001010002
01020101010000020202020000000700000201000101020002010002010102010202010200010005000100020206000001000002020501000100000000010207010001050001010002020102020001010202000201020002010100020202020201020101
07020202000200020102000100000102020101010802020200020202010002080002000100080100000000010108010006020101020107010002060000010000020201010208080102000105010100020200020001000101020702020100080201060200
00010002080100020002000201010201000200000107010202000002010100000000000100020006010201050800020000010105020100010001010002010102020101020206000002000002010102020100020102000001060100060001010101020100
01020100000202010001000001020100060200010201010200010100020000010101010205020008000102060105010201010102010002020102010102010200020101020002010701000202020000000102010102020201010201000200000200010002
01010000020105020102020105000101010102010000070201020201000201060200010000010102010600020002010202010601020000010200000001010101000001020005020201020006010105010002010208010000000101000002010002000200
01000101010100000007000207050700000102000607000602020102000201010005010602020101020102050102020200000001000006010002000101010102010100010202060002000107020001000100000601010102010202020201000201010000
02060101010502020101010001000101000601020100020202000206010001010102020100010001010000020202000000010201010200000200020201000000020101010000020500020202020602020202010100020201070200020200060001010001
00000002010802020101010102020600000101000101020201000102020200020002010100000000020106010000000602020002000001010102010105010202010001020001020207020200010000020201060100010001010201010000000000050101
02060005070000010100010101000100010202000101000802010001010002020100020001010100010000000100010207020002010000000202010000020100000002000001000000020602000002010701020200070100010002000000000000020201
02020201000201000005020000000101020201000002020202010002000002020001010102020102000100020001010002010102020601020101020000000000010202060202010200010200000102010200020201050500020200000102010100020001
00000201000606020802000005010007000001000800010101000101000000010000020001020208060200020001010200020200010207010002020002000201020100020205020002020801000106050100010700000001050500000502020000050201
00020102020100080208000000000200010102000000020002080800020101070002010101010102020000010702020002010800010201020200050205060602010002060001020208000001020002000102020201000201010202010207020002020202
00020201020100010100010201000801000102000202020102020201010202070202010002020200010001020201010002020001020200000101020100020101070106010102020102010100020200080007000102010501020100000202010200000200
00020001010201000100000202020002010000000106010000010006020701010001080002020201000000020000010101010201010000020001020001010801000701010100000106020200010601000000000000020005010202000202020001020000
01020202000100020002000202020100020002020201000200020001020001010600010100010102020602020202020202000002010802020201000102000600000201000201000202020100010000010000000102000000010000020101010207000102
00010201020000000502020202020100050501020202000201020502000000000200000101010106060206020000000201000001000200020201020101000002000002020100020202070101000000080002010200020001010002000002010000000102
00000102010101010200020200050201050100010200010101000001020000010206010201010001000202020002010000020205010001020201000207020102080102000202000101010101010207000001010202010201000001020100000102020605
02010702000200000101020200010202000002050201000000000202000700010601010802020101020000000202020002020101020002010201000002000100020000010200020201000200020001010501060001000100010108000201000200010202
01050200020001020200000000020201010202000202000001010002000102010101010101010001000100000105020101010202020102000208010001000700000102020002010102000002000200000508020000010002000100010801010001020100
01020002000102010202010102020100010200050201010005020202060200020201020001010001000201000201010107060008010102020200010101010100020502000202000000020102000201020201020100020002000001010002000100080102
02000200020000010100010002010508010002010102010101070201060007000001000102010101020200010206020002000201010000020202020206020100080202000101010600020101000100010202010102010100020100070601010000010002
01020201000101010002080201010105010101010201010202020101000800020100010001000001000000020202010200080700010000000100010105020202000002020001010001060100060601020101010101010200000200010001010101010202
02000001010202000602080001010200010001010702000201010202000100010102000201000002000201010100050801000106010500060100010201020200020102020002000208060001020200020101010001020000000100010101000002080101
00010200060002020100010201010000010801010002000002070002000001010100010000020201020001070100020202020202000202010001010001000501010000010202010101010201000201000002020100010100010206080002070001000002
00080101000201020202010200000200000001000000020002000002000201000007010002000202020100010202020205020001070002010102010202020002000001000001000100000101010201070100010002000106020001020000010201000002
02010100010202020001010602010202080201010100000100000201000102000800000102020002050802050700000105000000010006070201020000020000010102010007000202020002020101000202010602020101000601060001010007000202
01080201070801020100010808020700020201010101020005010601000100010101000102010101000501000602010202020205080000010202000101010102020002000105020001000102060102020206020200000106000001060000070007010200
01000101010002000201020202080007020000020200000102000100020001010101010102050002010000010007020202000000010001000002000200010201020800000100000107000202000000000202010702020000070205000000000102000000
01000200080106070102000702010001020001000100020102020002020002000001000200010101010202010501020601000105000001020000000100000100000102020206010101020601020201020102010200010100060102000101010001020200
02010201000100000101010102060200000000020100000201020201010201010108000200010001020101020102010207010101000501020202000202020201010001000100000000010102000502000000020001010201060102000201010002060101
01020202010700080001020208000205000000000102020002000101010601020001020202080100000200020102010002010201020002020102010000000000000702020101000600010107000005020001010002020200010100000002020202010205
00020100010502010001010102000107020202010102020100020002000200000601000102020501010102020001010101010201020100000200000001000602020200000100010200020202010101020100000500020207020000080000010102000102
01010102020200000005010000010002020201000200020102020201020000010000000000020000020201000100080002000102020202020802020702010002020201010100000105020102020102010001020502000002010502070100020001020101
01000200010802000106000001000200010202020208020002000101070100000002020102070200020200000102020000050206000000010102000000020202000202010201010101000102020000010002000002010200010102020202000200010101
00080202010200000207010200020205000100020102050002000002020106010101020000010202020100010200020602020202010102020101020000000000020600020702070701010100000202020001000000020002080005020200010000020202
02000207000201000208000500000000020100010102000201000201000100010600010000020201080000010200020000010200010207010000010001010001010101020001010105020002020101060105010206020101000101000101010206050200
00020200020102000600010000020200070200010102000000000005000101000101010102020002010502020207020102000102010000020101000202020105000100020101010000000201020201000200010001010102000101000207000201020001
01020002060200070005010600070002000200000507020201020006000107020002020202000002010206050201070108010200020001020101020202020101000002000801080202000201000002000005020101000202010201010001010001020101
02000000010801020100020800010201000100010101020201020101000500020002010002000002000001020200000008020100060200000200000808020201010200050102010100010201020200000802010100020601010202010201010102010000
00080601000101000002050200000001010106080200010101020000000201020002020201010500000100010001000202080200050200010001050001010202020000020000000100010001020002010001080100020000010002020000010002000100
02000201070107020101020002000002020702000201020102010101010205080101000100050000020000010102010000020000010500010205010001010802000202010100020001020601020201010102020200010000050200010102000000020202
06000800020801010100070507000105000205020002020600020102020202050202010105020202010000020002010106010702000100070102020101010202000701000002010100020001020200010500010000000102000000020802010100020602
02000101010100020102050001010202010202050000020001000806000106010102000001010100000606000200060200000200060000000601000006020501000000010702020002080205010002010201010200000101000001020701020202020202
00010101000201000502010202000001010002010502020200000601000000010102020200000106010102000202010700000002000200020202000201080001020802010100010100000201000201020002020102020101020001050102020202010501
05010000020101010102070202020007000001020101020701080005020202010201000102020501000201000000000000000201010702010002000002010201020101000102020601010100000002020107010102010101000200010102020100020001
00000202060202000101020200000002010108010001000001000002010202020105020000000000010200020101010202020102020102060702020201020101020001020200010102000201020202000200010208010002020100000202010106020102
02000000010002010205020202020001010207020101020101020201020106020101020200000202020001020000010106020007010000020002020001020701020201000500000201010000010007000002010001010107020108010002020100010200
02050007020006020200010000000100020002000702020100010201020801010201000102020801050102020200000002010100020100020002060600070102000000010001020002000001060102060000020701020000000002010202000202020202
01000202070000020101000102000200010202000201020200020102020600020001010202080202020202000201000201010700000201010000010002020002020001010102010101020701010002080008010107010000050100010200010002050206
01020102020702020002020105020201010201020002000200020202010802020102070006020108020100000206050102010001020100020200000502000000020001010201020202000002000002020101000102060200010000070001010001000102
00010200000205020001010200010207010101000102000200020100080002000201020100050502010000020200020800020106010001010200010802010101020202000001020000000000000002020101020205000005020201000201000701020000
01010002020202000002020001000501020002010002020102010101020107020101020600080200020002000200000501010000080501010002020201010008020102010100000600020201010101010100020201000200020202000002060200010202
00010101020000010200020100010205000602010201000101020000070200010202010001020002010000020201010202020001020200000000010208020501000102000102000101000106020605000200020105000001020002010200020100000202
01000102000100010001010206010002020002010101020202020100020101000102000100000801000006020202010200010106000002080002080101050002020202020802020000010102010008020005080501010101000102010200000101010708
00020100010101010100020201080100010202010201000802010000010002000002010201080200020000070200020201020001000100010201000202010002020100000101000208010002020102020501010202010102000200010002000101000102
07020000010001020101070101020207000201000201060200020008000101000006000201010107010200010002010107010701020600000106000008010000000202000201060002020002020201060202020200000001020000000101020102000002
00000001020102070102020100050002000102020102020200000002010000010801020701000801020002000101010202020105010002020002000001020102020701020106010802010100020102020805010101000107020000020001000100010001
02020000000102010102000002020207020202050800010200010002020100000100020201000201060002000000010202000102020201010001020106010008020001000001070001020102000101010200020501070102000005010201020200020201
02020100000201060101010201070000020100020201010001010001010001010100020101020001020000020102050205080200020101080201010201060701000002020101010001010202010001000201080101000202020100070002000202020100
02000202010002010201020202010202000201020102020100020101000502010001010102050102010000000100000600020102000100060200000202000201020105020202000201010101000000000202020101020602020102000005010202000206
01020202010000020102000100020102000500000002020000010202000200020100000202050000000102010200020702020101070802010101010000000106080202000002010102000001010201020102020102010100020102000100010002010200
01000002000101000208020102010202020002020001000002010100010200000201080201010000010102000000020101020101000001000002060100020500000201010201000601000001050600020107000207010002010202010002000202020102
00070001000006010102020101020005000101000100010100060202010101010101020002000201020208000202010000070001010201000100020101000002020000000502000100000105020202000202000102010101000101010102010100010000
01000100000002050100000102000801020002000106000100020001060002000002020200010101020001010202000001010201010101020200070206000100060201020101010100010000020700020100000002020100000202020102020202010100
00010200000202000001020102000200010100050002020001020202010100020002020000000201060200000106080702020001010201000006060201020202020202070101000202020002050201010002010101080001000108010000020201010600
02010508020700020202080002000001010107010001010005000102020002000001000000020002000100010202010102010101070201010202010501020201010102010002000002060100020200020002010200000102020102000000050500020002
00010006010201020801020000000002000801020101010201000002020101050001020000070100020101010506010001000001020000010000000201080100000201010000000200000202020200010101010000000102000007010201010201010201
02000202020201020102010202000100080200060202020001000200000100010008000702000100000701010200000108010102000001010000020105020100050801020200060102020007000200010202020200000000000002000201020101080202
01010002020101010201000201080100010201010100010001000202010002020106020202020101060100010201010001000600000001000100010201000800020000020108000102010500000200010201000002010101010200010202080006020500
00000201020000010206010001010001010008000200020001010200060802000101070101020101000501020102020000020202010002010106020102010201020101020800010000080202010200020101010002000100020501020102020200050100
00010206060002060101070002000100020102010000020101000501020102000102000202060002020002010202010002070102000000020506060200000000050002080100010200000000010201000102020001010002010100020001010001010702
00020101010002010000010100000800050200020102000208010001010101000002000202010002080100010000000100000000000208010000000102020002020000020001000202010200000202020002000101000100010202010200000200010201
01010000010801080202010200010002010601000002080201000202000101020100080007010106000100010105010202050201060102000002000202020200020102010001000008000102060101010002010200010001000100000107060200010101
00000002000202010102020005000102010208000501000200020600020106000200000202000005010100000001020201000202080002020200000802020101020107010000000202020102000201010101010701020701080801010202000002010102
05000202020200050000020002060100010100010001070101010000020500020106000701010000010001020202020006000102010100080001050201020800010001060002010100020107000501000102010000010500020100000001000000000102
02010100020202010002020201020102010000020108000102000500010201010202000101050200000102010007000000000002010201010201000001000208020101010100000700010102000201000001010100000202050100010101020102010101
00020602010101020201010200010500000202020202050000020202020205000207000202010200010200010101020100000002000200050102020202020702010002020202000201000200000105020101020201010102020202010001020002010100
01020100010001000207000201020102000202010100020201000200020000010002000100000202020202010202020101060102020200000100020102000002000000060201020102020202010002010000010000020002000102010100010201000002
00020001010105010100000202020102000001020205070102020002020002060000020202020001060100000200010101020202020202000000020502070000050000020001020201020201000100010201020002080101000001000006050100010200
02080100020000050001020002010502010000070100020002020207020002050700020200000201010100020006000001000202000002010002000001000002020202020002020102010102010000060002070000010202000102000100010100020601
