01010100020201050102060201020202020005050202020200010000000202020000010002000200000007020002010101000001010101000201070102020202020002010102000701010000000102010001080207000002010200080202010101010101
01000200020200000102020002070201010202070101000202000006020102010001000802010200010207010106010108010105010100010002010202020501000702010201020200000001000102010202010102000002020201010102000202020702
00080201010102010002020001000201020102000602020001010200020001020200010101080001010208020002000102020102070001010201000202020201010100000002060100000100020102010207010006010102020200000102060001010202
01010202000100010207020000020201060100020701010101000001000000000101020102020002010200000100000102010002010102010101050202080201060101020202010201060000000105000201000000010101010102000000010006070201
05020801000001010008000100020100060002020101000201050100020101000000010502010101000102000000010202000202000201010001070006080002000201000102000100020001000002000001020501000201010005010000010100020202
00010201010100010001020100020000000002000201000602000201020001010002010201010101010101000101010205020008010201080207000101070102000200000202000202020202020001010206010001010101010005010000020202010000
00000102000202000002000000020101000001020000020002020002000002020101010200080101000002000700020501000106000200020100010102050202020000000000000001020200010001010100010202010001020200000701020000020600
07010000020100010102000101000201000100000000000101000208010702010002010101000101020002020102010002000002020108020800010102010200010006020100020001000102000007020007000802010200000001010200000100020101
00010002010001020002020002060000000200000001020201000000020202010201070201020002000002010001000202010100050201010200020102010207010001010700020001000000000202020100010802000202000601010102000201000102
00010100010200000502000202010202010101020201000201000200000200000202020202010500000801020102010101020102010200010207060202010101000201000000060102060102000102010102010001000000020000000000010106060107
00010500000100010101000102000602000101020000050202020201060200010000020201050201050101000600000001020108020801000001010200020002020502080001000001050200010000020200000202000802020002020201020200020100
00020202020101000001000202000100000800010502020102000202020200010200010000020200080202070100000000000000000200000200020100020101010200010002000100010202010102010201000202000201010001010102010200000200
05020001020202020102000001010101000801060201000800020601010106010200010002020001000001010202070102010802000101010002010100020200060207000202020102020202000102080801020107000107010101010007000101020201
00000002020002010002000200020102010708000202010001020007000001020201000007010100000200000100010102020105000201020206020200020800080000020100020202000000020201000000000202070102000500000102020201000201
01000002080000020002010000020000010102000201000200000101020201020107020000020200010100010202010106010100010201010002010002020202020101000101010100020602010102010001070202000001020001010101010000000000
02020202050000010202020201010100000002000705000000010202010200000201020101000000000200020200010200010105010000000201010000020200010101060201020200010000020100000207010102060102020002000201000000020102
01010000020000020200010000010001010000020202050200010100020101000001000101000102000101080002000100050002000002010102000100000102020002000107010201020200020101000101020000000207000101000202000202010202
01010100000002020101020201010805010000000502000208020000000000050207000200020101000008010107070002010100010107010001000102020102000602000100010101010202010001020000000001000100010000020000070206000101
01000806020801020102000202020200010107060200020101010102010100000202010100010500000700020200010000020201010101010208020200020002020001010102000000010002050006010202000200010600010702000000000201010100
02000200000000000102000102000000020100020202010202010801020001020100000106000201020201000502000000000100070202020202000201010202000005010100010602020108000100020000010000000100020201020100020700020000
00010200010000020102020002010200000100020100000200020101020100010101000108000208000202000501000107010101060100020001000102020202000101000102020102020102020600000101020100020008000002020101000202010002
02000202010701010202000802020201000002020002010102000100010102000601000001010508010201010101080202000202080002020200010200000202020002010000010101010008020207000001020201010205010100010201010102080002
00000201010007010102010102000500020202010001000000020000020001010102000501060000020500050105010200010001020101060000020002020002010200020008000601010102000100000008000201020200010000020100000108010702
01010100010002000001020000000202050002000206000100020201020001000102020200020002060200020001010001000000010002020601080102010001010002020105000207010002020202020202000601000201000100010100020102020002
02010101000001000001010607000202010101010101070701000700000202080002010208000101020200000201010801010001020001020002050200000007000001000202000001010101010101020200020606020200010200000102010201020106
01070700070108010001010800010102010600000100010002000200000101000100010008080602000202010108000201000100000202000001010601000001010602010201020501010808010208010002010202020201010102020201000200050000
01000202000000010201000001010002000002020002000002000201000102010101050100010102010700050102080100010100050202020200020101010101020001020106000201000101010002050102000102000200010102010102070101020002
01010202020002010102010001000200010202010000000101000102020200010007010201020101020002000202000507020000060002000100010201020101020100020200000102010101010701020005010101020102020201000002080201010201
01010102010001010002010101020000020002020101020002020202000100050001020000000002020100010002000202020002020006070007020002000002000502000100020106000000000102020201010102020001050202020201050000020202
01010001020101010700020002010202010107000500020002010202020002020007050501000001020202010100000202020601050100020102020000080100020200020202050000020201010000010001020205010000000501010101020101020002
00020002010001000001010102020500010200070102000505010001000202020000000101010002010202010102000101010201010201020000000100020200050202010101020201010100000100020002000600000000020001000102000200020206
01020002010202010100060002070002070200020202000201010100000202000807010202020001020000000502010002000106000102000102010202010200010102020000010200020001010005000201000102010106000000000101020001020001
00000100000001010200020200020102020200010000000101010208010102020202010000080500020001000002020101010100010100010102010107010202020100010602010002010206000002080100000200020500020001020202010000080001
01000005020002020101070101000000020102070001000101000108000001010102010008020201010001010201010202070201000101000200020002000202000002020002000001050102010001000000020500050000020201010201060202000202
06010001020502020201010200050001020002010101000102050000020007010201010101010200020802000200020101000200020602010102010102010000020101020001020000000008010002050000020201010202000802020000020501000801
01000100000001010100050001020001010001020201060102000800020101020001020102010201080007050200000100000600010801000202070600010202000102050501020202010201010108010100020200000001000002000102000200010100
02010008010002010001000200020100000102050202020201000202000002020102020101000100000201010101000202020202060201020001020201010107010000050106020101010000000608060001000202020202020201010101010201020100
00070005070208010201020102020200050001020002020002010201020100060201010102070001020201070702080002010000010000000102020102000200000200020100060200010000010002080101020205010002020100010001010101000008
01010001010208000100000000010202000101020001020101010202000200020201010002020102020208010205000002010202000200010102060802010802020601000000020002010201050102010007020200000002050200010100020001010502
01000202010201020002020000010105050002080100020001010202010701010101000102010202000201020101010100020101000102010602000201020002000002010001000000010100080006000201020101080001080000000200010202000001
02020200010200020207000200020100010100010002010100000101070702010001020802020001020102000002060106010100020202010101020200000001020007010202010600020202020201000002000100020002000100000200010201050002
00020202010201000100000101010100010601020108010200020001010001020102010500010001010202010102010102050701010101020202010100000508060801000006000000020102000001070201020202000100000002010202000100010000
07010100010205020200000101000605020000020200020007020101080002010102000102010001060202010201000700020000020202020202010101020807020202000101000001000002000201020200020602010102020102020101010002020000
02020201000002010201010102010200000202000201000100050201010000020200000102010600010007070101000800000202010108020200010200020202010202010701010101020201020201010202000102020100010202020100010101050601
00010100010001000000020200000102080101020001010002020102020002000001000502010102000102020607020000010000020100000101010001070202010601000502020001000001010701010002000601020100010001010202020100010208
00010002070100050102060000000100010002020202010101000200000100000202010208020200020102000202080200020100010007020200020001000100000501010202020101020001020100000001010202020101020202000100010100020100
00010106010700020102020102010100010200020002020000010607000001000201010202000100010500000001010100010200000107010205020605080101020101000108000102000200000201010102010200000105000502050202010601000202
02010502070100070000010201000200010002000202000201050200010001020002000001000201000000010201010105020000000001000102010101020001010102020100070100020001000102000000020002010102010202020000000200020006
02010200020100000005010107000101020702020201000200000108060600000000020100010000080205010106020002070202020201000201010102010002010008010000010500020201020201020005080102000006010101010101020200020202
01020201010501010102010502010108010201020102060101000200010201020201010202000101000201010002010202000002020102020206000102000001020202020102010102010002000601020101010200000200000501000700010002010001
08020101000000020202000000020200000200020002000102020000010202020102020202000601010800010002020601050001010007010002010101000102010202000801020001000000020001020102000000020101020000020202010800050202
02000100010100000002020201020202010102080001000102000001050202010002010201020002010202020200000205020201060200000200020101000102010502000101020100000602050001000805020102000000020202020200000102010805
00000001000102020102000200020002020202070202020002020800000102010001020201020102010100000102000000020102010001010100000000010108020100000101020100000201000801000200070101010508070105000001020000010001
01080201000200020802010201000102000200020201000200020600000202020000020202020102020000020200010501010002020202080602010002070002010002010202000102010101000001010000000200060101000002010206000001010101
01000202000502010102000202080800020200000500000000020000020007020002000002010200070101010200010202000001010001060002000100050002010101000207020208000102000001020100000002000200000200020102000000000002
01020201010100060206010105000000020002000000010202020102000102000000020001000700000006010101070600000102000500060201000002010100010102010101020201000202000101000202010101000100000001000101010000020202
00020000020000010207000201020202000201020200010202010001000101000202000502050101080200020702000202020100020200020200020102000201020200010002020200000000000000060107060002020107020601010100080001020502
02020000000102000001000102000201010102000000020002020001000600010502000202000201020200000101000001020202010102020201010201010201010100000201020000000102000001000000000201000000000102020001010202010201
02010001010200080206010102010102000000000102010201000201020102020002020002020101000206010101020202000201010601000202020202010001010201020100010202000002000100020202010802060100000000020101000200000100
02070100000000000500000000000800010800000101000202000101010001020201020102020100020700020102000100020201020002000002000000010107020200000001000001020202010101020100070801010800020200020207010002010102
00000002000008000102020002000202010106000201000100000102000002020106020207000001020202020100050802000001020701020100010201000002020202000000010000000001000100000000020102010005020100020102020001000701
08020102010101000000020000010000010008020102000201080101020102010100000101020105010101000501060102020101020502010105000002080100020001010100010101020200010101000201000802000202010200010001010207020201
00010201010806000105020105020002020000010107010002010802000000000700020200010002020101010200020200010001000000000102000000020002010002020001000001020200000002000101020101010102020102000200000000010006
02020000010002020108010000000002020006080800020102020001020002000201010001000200070200000102000002020200010200010105020002000102000501080001020200020002020207020200010201000200020001000106010100000101
00000107080205000602000000000001010105020002060202020100010202000201020202000602000201020200010000020201020501020001000001000202060700070200020000020100020201020102020000010201010601010002010200020000
01080102020201020002020202000208010100000002020200070200010101010702010206020800020106010000070001020700000200000002010101010202020000000000010202020100070102000208000102000106060101010001020701080101
00000200010001000000010200000202020200020202010602000201020102020702020001020200020002000100020202000201010107020601020002070101020202000101020502000101020001020102020102020107010002010102010100000501
02000202000508020102020202020200000000000200020102010202000102060101010106000102000005000802020201020100050101010201010202070006010202020101010200020100010208010202000000010200000601000107010000020201
01070200060001050108010101070000010002010201020501010201010200020202010200000105020006010101050100010200070002010206020002000600020501010200000101010200060200000000000000000102060001000602000501000201
00070200020002000100020701010002000100000002060100020802010200000102000200010002020000000102070200020100000002000200010102010200020202010100070100020102010102010202020100010001000200000000000100000708
02020102000002010602010001000202010102070201000000000002020002000208010000080001010102010202080202070002000002020100010105020001060102000000020002000002020201010102000000020802000102020100000002060002
01020200020501020202020202010201020001020000020200020002020202010101020102000100010102010101020200020202010008050200020100020001010108010802010205020202020002000200000007020000060608000000010102010101
01000101010100000000000002020001010007020002000107020000000201000100020201050501010000020202010600020001000205010201010100020102010002000000020101010001000600000801010108010201050108020200020000000008
02020001020002000001000100000101020105080000020200020201000000060202000502000501010100010201000701000000000201010202000006010100010001010802010800010206010601020502000001000202070102010001010700000202
00000101000100050201000101020200010101010202000008020102010202000005000001020102080001010202000201010001020201010102010201000001010200020002020202020000020002000000000206010201000001000202000000000200
02000701010600080602000201060002010101000001000201020101020200000202010202010001020101010002010602010100070802000101000101000201050000000000000101010102020101000101020200010101020002020200010100000002
02010201060101020200010200000007020202010102000202010200000000020202000102010002010000020201010001000200080200060001010200010200000000080205000102020002000202010001010100000201000101000002010101010201
02010000010001020106020600000800020002000600000200020100010001000200080101020002020202000006010202000100020200020801020201010200020007020201020101000201010000020200000200020101000201010001020100070200
00000200020100020100070100010001020202000101010202020006080208020200020702000601000005020102020201010201000200000001010200020102000101000702020001020500000002010200010002010002000001010102000100010202
00020102000007000202010101060200020101010102000106010001010001020002000100000001010000010101020200020200020006020101070201020200010101020000020200000201000000020101020705070202020200080102000202010101
00020106020202010000000201020200010101020100010101070001000001060201000001000100020102010001010106010002020200010001060101020000000600020201000208000100000101000200010101010200080100010002020700020102
01020701020201060005010102000002010200000001000001080200050100010102010108000207000001050101000201020100010200020101010002020001020002000201020200010002020201010202000200020000010000000101070102050202
01000002000800080000020100080200080000010100010201050006020100010100020800010106060202000200000000010001000000010201020200000801000100010201020000010102010007080200020000000200020202000201000200010101
01010002020001020501000101010201020202010001010101000001010101010202010207010802010001020202020202010100010100000000000101010101070200020200000102010101010102000102080202000101010001020008010001000800
01070100010105010100020200010100000101000601010600000005020000000102000101010500000200000201010006020201010100060202010201000800000102080101010202060001020102020101050202050100010101000001000202010000
01000000020005000500000200010201000200000200000001010801020002020001020200070201000001020500010101000001020205080102010202010002010002050201060701000005020201000202050101010202010507010100020201070200
01020100020000010101010201020102010000020502000202010002080100000001050200000102070101000000010201020101020000010000020101020105000101010200010101020102000102020001010001010002020602020002050200010002
01010002020200060001000201070100010100020000020105050002020100000101010001020206000101010002010200080005010202010201000001000802020100000207020102010002000102010601000002000100020201010200000202020101
00020201020201000200020008000200000001000100010200010000000001010202010100000202020202000101010102010200000100080000020000000101020002010100000200000102020801000100000200060005010100010602000002010002
01010601010001020501010102000801010202020100010101010000000102000000000100010700020000000102010501010000000200050101020700010101020202000201010001010601020002020102000000000000010101010102020000020008
00070002020000020501020001020101010101010802010102010102060501000100050108010602000202020200010202020100010200000202070100000500010100000002000000000206010105010202010101000202020202000002000002020007
01020101010000010800020102000002060002020000020005070008000002010200000202020106070002000200010002000200000102000101000008010202010202000000060001020000020000000000000002000201010205020700020202010202
02010208010600010702000106000800010100020201000202000000000002020208020001000200020200020202000201010001050002010201060200010202050000010002010100000208000202010002000102010002000108050000020201000002
02020207000002000201010102020700020001010202000001000502020205010000010002010002010202010108000100000001000101000200020602010000020108010102020000020001020001000000000207000601010101000102020002010200
00020201000202080202010101070100010001010101000102020100010201010100010200080102020207020200020102000201020102020101080001010107010000000202000201020000010200010205000006000100000000020002010000020702
01020102020102020102010002020000020000010202000201000200020101010102010102000101060101000200010501000108020200000100000102020100000200000002060101010201020100010000010701010101000002010202000108020201
05000100000102000105010100000202010102020001000202000000010008020501010001020000000102000101080202000002020202000201010201020200020006020800000202020101000200070702020007020200060101000100020101020000
01010202020102010100020201020201000201010201020106000101020201000100020102000001020001010201020100020205020001020001020202020200000200080200020002010000010100000200010101010102020800000100020001020200
02020100020200010002000002000205010000020102000200000200020006020202020201010100020200020601020100060001010500010102000101020200000105020201010200000002000201010801010201010202020101010200010100010002
02000001020501000202020000010102000101000101050202010000000001000200020002060201020802010001020002020102020500000101010200020100000700050200000002000001020802020100060101020107010102000002010102080208
