07080108010102020102020001020000020100000106010201000102000202020601020702020201010800010700000100010507000002020202020101020107000000000002000002050001020200000602000201060706020500000200020001000101
01010101070100060701010002010101010006000102020202080000020102020100000000010202010202010202010002010100010701010000010002020200010002020102000000080000010102000101020000010202020101060000020101010006
00020101000002000101020100000000020002000102010202020000020202000200070000010100010100010702000102010202000202070002020102020201020101080002020100000001020000020000080000010002010100020002000807000201
00010200020106010002020102000200000202000101010001000100000002010001010201010200020101000800000002060201000100010702010200000200010002000107000201000200010501060002010208000200080000000100010001000200
00010000020001020101010000020200000102010100020202010007010201010200010000000200010200020200010501000202010000020800010100020001000202060101010102010200080802000001020102010605080201000001010101000000
00020200000001010000000100000100020102020000000002020101020201010000010200000200000100010000010202000100020001020201020202000000000102010200000102000202000100010000000101020001010000000001000202010100
02060105000802010101020602010200000600000001010201020601020000010001000101000000000202020002000701000002020206010102010102010000070000020102080001010001010100000100000200010002010201000702020201020002
02000201020005010206020202010001070100010002060101020100010202080102020602010002010102010102010201000202070102020107020100060201000105000006060001010801010002020102020202000600020100020107000102020101
01000202020101010201010201020002010200000008020701010200020100020202000101010002020101010107020201000601000200020101010100020600010201000800000007010800010100000102000701080002050200010800020105050201
01020000020100000000070602000201000100000006000600020102010202010201010102020200000002000101000000010002020200020201020200010801010001010102010000010101020202010202000001010207010101020000000100000701
01010102010701080100020000010102010001020101010800000007020202000101020202000201070100070100010001020200000002000001010001020201000200010102020202000102010002020500000102010201010201020201000206010201
01000202020100000201000802000100010201010108010100010102000200010101020002000201000102020100020001000102010102020002020101000000000001080001020200010000020000000100020600000101020102000001010501000201
00020001020200010200020100050202080201020001080002010000080002010202020000010100000200010102010201020702000002000200010100020801050201000000010100020205010201020100010200020002020102020000020202010108
01000201000601000000010002000001000101000200000601020102000201000102060102000000010100000200020202000101010202000200080006000100000200020102000202000201010806020105020000000201010002050108010100000102
00020100010100050001000005020201010200020502010001050202010201000000010000000202020200000100020100010101010002000000010207010100010101010201010202000102000201020106020207020006010002000601020001010500
01010602000201000102010201000001000102020202010200010000010802020202000108020500060200010602020107000102020101010102000101000000000600000107070201020102010001000702060200080102020201000001010002000702
02010100000201020007010001000200020101000601010002080008010200000002000100010002000000010100000000020000010001000101020200000201000108020007010201010000010005020202070002020802020200010202010001080602
01020801020102000101020008000000000008020102020200010800000200020101020001020207010001020701000108020106010101010606010202000100020100010001060200080202020201010001020102020200020201010201010200020001
00020100010205010001010202020105000200010200020101060001020001070100010200010102080201020202010702000100020202010102000202010002020100020102010002000001010001000101000102000000020000000006050001000102
01020202010001000101020102010001000001020002020000000102010101020200080102020202020001010000010102020201020001000701020001010001000100010000010501060205000000020100020100000008010200000202010000010105
02000100000100000001020201020100020001010101000500020000020008060100010001020202010701080101000202000201010602000101020106000002010107000001020000020100020100010201020201000800010800000106000101010206
01020000020105020200000100010100010202000600010000080102020201010101010100020102010005000202020202020001020108010501020100000200020101010102010201010102010000010602000202010000000001020502010101020202
02020101020102010200000201020102010002010702020000000107000102010002010101010007000202010602010001020000060101010202020002020202000208080201020101010202020205020100020202000100010100000002000100020000
02080700000107010000000001020202060100000000000100010001000100010005010202020002010001010201020001070101000200000002020002080101020205010001020002000002080101010102010102000000020002010200020100020202
00000201010001020200000001010200000501010207020102020801000100000202010100020200010202020100010100020107020000010201020500010002020201000001000101020102000200010708010007010000010201020202010002000000
02000101020000020101010001000001050001010201010802010202000200010202010202050101020108000202020102010200020802020000000102010002000100010702010001020201080001010101020201010002010000000202000201020001
00020101000200000200000201020202010107000001020200010102000500020100000000020001010101010000000002010200020001020002010001020002010102000100020005010101000000000007020201000001010701020102070200000200
06010201020602020102020202020102020202070000000800010101010001010002000701020102010201000205020101020202000102010102010202000101020001000002010100020200010802000002000000010000000001020205010001020201
06020201080100010200000508010001000001000202020200010000020200000101020100000201000000020002000101000002060002020007010108010001010102000201020007020001010202000000010101000000010000020102020201010101
06020000020000010101010205020008000001080201000708000008000102020108000800010700000200010101020001020000010702010100020600000106000100010102010201000002000100010202010602000002010500020101000201010000
01010105050000000100020100010202010106000001000005000100000100000201010500000500070202000002050102020501010502000106060201050002020500010102020200000002000100000201050201000001020100010201000000010700
00020200000200050001000201010000010001000200010200000601010200010100020100010002000500010102000100010708010205020600010202000100000602060006010002000100020102070002020101020000020200000002020000080100
00020102010108000202020002020501050002010205000201010601020101010002020102020202010802000201020100060200000002060100020202000000010102060201010001010101020202000101010601020201000001000102010101020100
02020000010202000102050100020202010000020101010202060005020202000000000202000202020000020102000002000102000602060105020107020202080001010100000101020102020002020808010802000000010201010200010000020002
00010200010102000201020002010200000102010802000202050102080202000201020201000002020002010701060200020002020201000102020100060001000001000007000001020201000102020102010600000100000107000201020001010702
02000200020502010202010600010006020500020100000502010101080100010000020100020000010200010201020200010202000102020202020202010001020101020201080002020102020502000501020205020000000201010102010701020108
01000207020200020101050201000202010002010102000000020102000202010201010102000102010102020001060200000100020100020202010106010100000100020002010102000500000100020200050001010001020601010202010105000700
01020108010501000200010100000100060202000000020102000101000000070102000202010200020202020100000001000002010001020201020101010706020100020200020201020800020201000000010000010202000002000202020105010201
00020208000101010200020100010008000702000002010101060202070002020201020107000100070101020608020107010002080806000100010202020001000101020100020201000101020200020106010000000501020201020002010000010002
01010101000501010200020202000201020201000001020101000102020108000500020001020201060102020001070201000102020202010200080001010100010202020202010102010200020201000100010200020201010202010005020107000002
01000001010001000000010601010201020200000202020102000000020201000207010102000002010000020202010201000201000001010202010102010005000002010201010102000101010001020200000102010200020200010100050001000102
00010202020001010000010602000600020202010100000102000002020200010000020102010002020002000001050001000101000100050200010201020001000200020000020008010100000000020701020102010002000200010200060002020100
01000100010002070502020202020700010102000100010102020101000000020107020701000102020202020002020000080001010001010002010100020101020000020202000002010001010001050205070007010000080106000706020101020002
02010102000001000000000201000700010200020501020501060102000002020101010101010000020102010700020601020000000201010000020002010002000100000100010201020002000102060002060001000002020201080206010102000001
02020000000206010508000201010202010201020001010001020101000000000001000006020001010000010202000207000102020102010106050700020002000200000802010100020101020202000202020000060102000200010008020002020100
02020102020202010100000200020000010201020000020501020702000006070202010102010202010002000100010200020102010202010006020202010200000202020202000202010200020000060102010000020001010105020002050000000102
02000500000005020702010201020101000601080201000201020201000700010100020502000100020202020801020200000202010002020006000505020102060208010000020202000202000102020002000202010701000201010201020102000101
00020700000101010002000201000000020201010500070001050600000802010000000808070002000502020001060001000201010201000102000707000207010201020201020108020101010200020006000201000100010002020000020000080102
02080002020102000000000101050200000002010102020202000100020002020201000600010201000002000600010200020000020102000206080501000100010002010000020201020002070000020002000002000102020101000601020702020701
01010700020101000102020100010001020000020002000002020000000001020200000001000501010101050201010201010200010100020201010002010200010201020201020001000201000100020101060001010101020202000200010108010102
00000000010002000500020700010100010102010101010102000002020000010000010200010102000002000005000202010201000701010101020101000202000201010106050005000205010005000200020002000800010006060701000002020000
00020101060006010108010802080102020506000001080001000201020202010102080608000100020000020102020202010100050200020101010006010102050002020200000100020000010100080001000100000102020100020202020101010201
02020201010000070801000102050001000102020100070200010001000002070600010202000200010200010200020002000100020001020000010200010206020102000201000102080100020000020202000100020101010101020100010202020102
00070602010200010001020101010101020700020101050100010102000201020202010101020001020102010201010501000101020201000002020002010701020102000108020202010007000000010101020200000801020100020101010201000000
00020701020206000000000100000500010000010000010101000100020200000701000206020201010100010207070205020201000101000001020001000200010600000002000100000202020100000102010008000201010202010200000100010202
00000101000202020202010101050502010100020001020101010200000201010002080002000002010200010202000101020001020102080202010001000102010001010101010802020606020202000002010201010100000702000102010106010100
00020100020000000202010202000200000000010100020000020001000101060101020000000101000101000000000208020002000002000802000100020102010201000001070100010201070000000001010001020501010600010101070202000802
02020002010002010000010207010202050200020100020107010201020106020505020201010208000100000002060000000201000102020102010202000101020000010000070106010608010002000205020202010102000202020102010202020200
02010000000006000002000202010201070202070108010002000202000105000100050001000001020102020200000002010601010201000202020101050002070000020001020202000000050000000201020201000107000102000000010100010201
02010200020205000001010000020001000201000102020100000101020001020102000001020502000002020100010200010000000002000100020002010000000100010000010202020102020005060100010200050106000000010000060201020102
00080202000200010000000801010701010200010101010100000202010200000102020500020100000202010000010201020201020200000001020001020205020102010001010205000000080702010200010601000200020002010001000001060201
00010100000002080102000201010202000202020101000100020100020001080100010102020706010102000200080201070001010102020201000508020002060105020102020202020001020200020500020001010206000000020000010000000001
02010000010200020102000000060700010108020701050101000201010202070201010001020102010106000202010002020102060102010200000100020002020101010200020002080006020101020200020001000102010002000200000101020701
02010008000005020001000101000000010105020000020000020101080705010202020002010202060101020200000102050100000001000001020801020700010002000202000101050107020101010001010107010102020202020200010201000100
01000001020600020202020101020100010102010501020001010102020100020202010206010201010202070000020100000101010700020101010102020100020101010201010001070202010100000001050207010000070802000200020101020100
01010802010102010101010202010101010502000202000201010201060200010001000008010001020002000201010002060200000202000102010202000101000207020001010201000102010001010201010202050201020202000102010101070200
00000007000000000102000200000006000100010102050200000001010002020000060000020602010200000100020000020000010102000001010001020001020205010100000001000102000008010201010201010101010602000101020100000001
01010200060000020001020107010208010002000600000001010802000101010101050102080101010201000201000102020102020000000002020202020101020102020801020001010101020201000001010008020101000101010102010102010500
02000201010102010100020000010201020002000101020000000005020100020205020000000101000000000201020007000002020200020202000001000200010100010101020202000702010202020200020101050200010002020002000101020208
00010002020101020000020002010002010102020001020001020002010500010202020201010002020200000000050205010002000201010000010800000802010102020002000007020102020108010102020100020101020100000000000001070100
02020201020201020001010806000000020101020000000002000200010100020000000001010200000005000202010200000102020201000501000002020002010002020601000000000100020202020200000001020002000101020101010700010201
00000201000201000200010201020002010002050100020102000200000601020201020202020201000202000100080202000107020101000501020200010501020101000101000002010000020002000002020001020008010101020000060005020102
01020001000100000002020101000200080100010001000002000200020001060000020000000107020002000001000100000102000202010101000000000201000002020500010108010502010602010102020102020102020001000007020101020200
02020001010802020101010601000106010200010602070201000001000006000702020201050101000002000200010802000000010202000206010202020000020201010102020101000505060001070102020700020700000001010102000100020008
01080005080201000500020702060101080102010000050202010100000100080202010200010202010201010000020008020201020000020002000001020000010206010101000202010102080100000000000200000201010102010000020001000002
00010101000000010101000200010105010000010100050101020100020000000002010200000102000000020100000101000100020201070201000201020102010100000101020102010202010001000100020001000801020200020201020005000000
00010105020500080201000201010102020001000102020605000200000200010001000002000701000001010202020101010101010001020001020201020001060200000000000200010702020200000102000101080108070202010601000200000002
00020000070202020100010201020205020100020001010001000800010101000102020207010001010801010201000102010808080101010000010006080106010001000100000802010101020201060101020201020201010201000002000002020001
05000201070201050100000200010000010100010202020002050106000700010100000702060000010200000201010000010002000102010102000201000100020207010102080806060201010101010002020101020001010102000202010000010202
00010107080800010102000000000002070502010105050001000502010000000802020201000002060107020200010002020002020002000001000101010006000200000106080007010102020102010202010102020001010207010002000200020201
01010001010206060001010000050000010102010201000102070001010100000201010000000101000002000102010807000202010102010200010201070101020102010002020502010100080001020202020105020202070100000002020002020101
02020701000002020202010102000000020201000000050200020102000201010202000000020100000601020101020000050100000202010200010201010200000101010702000001020002020100020001010207000001020200070202000201000201
01010105010100020202010000000200010105000102020701010202000201010100010000000600000108020202050200000200000102010201000100050000000100000102010102000100020601000500010102020001000000010002000201010106
00010001000201020201010002000202010000020001060100010001000001010101010201000107020101000000060207000000000006080102010002020001000101000202000000000200010000000100000108020200020002070001020202010001
01020201010200010801020201020001000002010000080001010001000100010000010200000201000000000102010002070102010100010102000102020206000002020202020200000001020102000202020501000000020000010102010007010101
00000201020100010000020000010100010101020200010205000201010202010102010802020002020000020000010007010201020201010101010100020100010101020101000106000000020001050201020101020701010000050001020701010502
00000201000201000002000101010501070101000100000008010202050001010101000100020505000201010100020202020001010202000700010000070801050200080000000000020200020201010102020801000100060100020100010202000202
00020201080100010200010102000102020200020001010002020106000000010201010102010202010200010102000100010202000000000502010200000006020101020202020106010101070201020700000000000200020101010202010102020102
02010100010108010001010100010101000100020001010100020202000202000002050000010000000100020700000006050100000100020000020101070000010201010002010002020602020202000100010501000102010200000000020101000005
02050200000002000701010202000200020000010202000801000101010002000601000101020201020101010002000200020102020001010202020202010201000201010100050101000205010200020101070201010100010201020100000201010002
00000000010000000205000808000102020100070500020101050208010501010707010101080501010101010100000101020002020001000201010002020008000200010101010002010101020207070102010102000101000102020200020100070206
01010000000102010502000000020002010100010001020800000201020101020101000200010201060202020201010201010001010201000002050800000102010101010202010001000100010701020002020001010102020206020000020201070008
01020100010102000200000001010102050000080200010808000000010001020100000101020200010101000202000006020201000200010001020005020100000000000200020100010202000200000802010000020205000201080102020102000100
02000002050201010000000202050101000002000000000800000200020001020100010205020008010002000701000201000000000201000100010202010002020201020002020201010201010000000201000100010001010008010200020201000601
00010007010002020000000002010101020201010100020100020201010002080206070101010200010000020000020000000102020102000102010101000101000101000001020101010101000001000201010001070002020001020101010001060102
00020200000101020201010102000602060106000101070202010100000800010201000100000801010000010100000700010002010100000201020201020100000000010000080202020200020102020205000105020202000100020000000700010701
01000102010002000202000101020002060200080200080001010102000101000101010002020201000200020101020100010005020106010100000200020202000202020202010000050002010100000001020100020202050202020805000202000002
06010101010200010102020000000000020201060100010002000205020201020200010102000202020000060507010100010100010800010107020702010107020002010207010001000001010002000001010601010102010200020200020001020000
00000207010201010202000201020205010001010205000208020000020107060006020100010102010000020102000100000201080102010106000201000202000202020201000501000205010200020102080700000001020708060202010200000201
07020001020207010100000001050801010200020001000001010102080100010802020001000601010000010802000002080701020202010200000201000001020202000202010201010200010100060002020200020002010202000100010002020101
