00010100000002020200020108020202000002000201000002000201000200000002010000010100000502020001020208000001010002010201010101020202010200010006000001010100000100070102000802080100020602020200020101020001
00000102000102000201000201020000010200020002000007020102050002000201000000010001020001050101050206020101020106000005010102020001010802000101010100020101020002020001010201020202020201020001000101000001
02020000010807000001020202020002000102020101000101010007010202020101000001000001020702020801000000000101010101010201010202020702020001010201000200020002010001010000000000000006000200010100010101010600
00070002010002010102020201010102020101010202020002080202050507020202070002020000010001010201000102000206010100000001000002020201000000000506020802000201000001000000020102020701020102010501060001010001
06010600020200000100060100080100020201010002020200000102020102000002020502000202020502000101010006080101020001020102010201010201020102010801010201020101000101020000020001020801020001010200010208020201
01010101010002010200000102000200020200010001000002000201010001000108060101060802020001010002020000010501020002010101000001010001050002000201000100010201020101060202020001010002000101020200000002020000
00020002020101020201010200000100020102000100050200020201010101000105000200010000000201010700010101010000020502000105000702000001000502000201000000010000020808020002000000020200020001020101000002010101
01080702020101000207000100010000000201000502070602020508000201060105010600020100020208000001020101020206020000010001010202010001010100010206000100000201010201010102020200000600000000020002010002020201
01020002010101010201070001000000000601020102010107020206000202020001020000000001010102000001010002020201010001010201020008050207000002010202020102010000000001070000020005020001020102000001020500020107
00020102000001010201020102050100000200020600020100000200020100010001020001020000010102000600000002000001000200000000000000020100000202010100070101010100000801000500000201000002020001010205020002010101
02020101000200000701000001000702010100080200010201000001010102020101010202010000020101000201000001000101010101010002080201010200000202020000010701010102070000010001010200000200020001000001000701010208
02000200010000000102000102000102010500020201050001010201010100010002010100010101010201020002020000000200000100000000000000000102010501010102000202010601010002010602000006010002020002010107010101000100
01000202000002020000010202070202010101010706020201020202010201020101000206010002070102020100010100000102010101010102010502010602000000010207020201050202000001000107010000010201000100000201080200010001
01010000020600020101000000020100020202000100000000080701060200010001010800000101020601050201020201000000000000050102020102020001000201000202000202020007080102000002010100010002010001010001020701010600
00000002010200010808060102020100010000000001010002000202000102020201010208010502010000010101020602000101020202020202000100000008000202000000010100020001010002050102020101020701020601010000010200010501
01010100020000000101010101010001000000000001020206010001000202010202020100010000020101020101010102070008000100010101080205020100000201010201000801020200000001010100080002020202010002020102000002070008
02010200010801010100000200010000010101000102000200020200080001020200010102010202010100070100010201020001010200010000020102010202010201020100020000010100010202020100020001020101000102000200000202010102
01060200000000000108060100020000020201010100010002020002020100000000020002010202020002010102000202010101080100020100020201020202000201000200020701020701010002010102010000000200010002020102000102010001
01020102060001010002020101000002010600020207000701080100000207020101080601000005000001010000020002000801000102000007010201010202020000020700000605020001010002000201000102000101020100020202000001000005
02020101000001020202010002000001060001000200000000010202020002000208010201000201020002010100010000010002000205010100010201010200010502000202020101010105010201020100020501010002010001010101000101020001
01020002010101000101000200020201060701070000010102010202010200010007010000010005020201020201020202000102020201010200050100020001020100010101020501000201000201010700010200020202010202000001080200020601
08010000000000020000010000020000000800010101020201000102010102050002020202020002000100000201000205000000020101000201000200020100060200050208020007020105000000000201000001020102070501000002000201000100
02010006010101000101010701020100010201010002010600010000010002000101020000000202010101020101010102020000000200020206020000010000020000020100020202000102000101010102000002000000020000000200000100000200
01000202070000020202020100010002010101000100020201020206020100000200010200010101000000020001000001020208010106070000020802000102000201000106010001000102010100070201000001020200020208000200020001020102
01010001020100000202010201000002010000010202000201010202020202000101000002000201010102020002070100000202000002020101010002010001010002070002070101000006010001010102010002020102000201010102020102010000
00020101020201010205010100000005000001000202010200020002000200000000010701000701080100000001010102010001010107020001010200010001010001000000020001080101000100050002000000000002020101000100000200010200
01020105020002020100000202000202010000020000000002020101010100020600010202020101000001020202000206000107000000010500020000020801000000050001060100000601000207000001080200010102000600000101000101020101
00020101000101010200010002010001060107010000020700010106010200020000010007020201000001000000010101010101010100000201060101070100020101010108020100000100010801020100020002020002020102020102070102000101
05000700000001010201020502080100020101010200020000010100000101000102050202000201000101020001000202010502020000000202020101000001010002010100020000010001020201000001080002010000020201020007000006020201
02020700000100010700000205010207010102020201060100010001010201010500010002000100000100050000010205000000020001020002000106000000020202020200010202010001020001020000000200020207000102000100000208000008
01010001000005020100020101020100010001060000010200020201020501020202010102010201000202010701000102000100020102010202000606000002010205010007020102020201000002010101010107000006010000000202010208070101
01020201010201010100050001010202020201000001080202010101020600010200010000020006000102000001020002010507020202000201000101010101020202000102060002070202020200010002020002020700000201020207000101010002
00010201060200010001000000010200010201000108020101000200010601010100020002010101010101020100050001010702010002020202010100050006000100020002000208010802000000010202000100020101020100050000000100020002
01000200020605020001020100070201000107020002000201000102000002010201000200020102020000000102020102020200020000000200010000020102020602020100000601050102010200010202020507020008010002020102000208000202
00080100020200010201000000020101020202080002000101000002080202000100010102000202000202020108010600020201020102000801020201000202070002020601000102020001000201000801010501000001010002000208070102080001
02010100020002010202010501000100020102010100010002020100000000020102010201000200020200000102020106020200020207010202000700080002020200000101010602010100020800020201020100020002010202020201010201020200
00000002020002000201000001020001000200050200000708000101010206010202020100010000010002010101050201010101020102010102000002000101010100010000000701020205000200000600000800000100020000000200020208010205
02000102000201020200010201060002070602000100010000010100000600020100010802000205020807000500010002010202020002080001010001010008010202070201010202010200020600000200000708010707000101080000000601010102
00010200000001000602010002010101010001020008000102020102070202020000080007020102000200000201000001020201010201020100010101010200020101050100060000020200000002000101020202020001000101000101020100000101
00000101000101060201000200050101060202050201020002050002010700000102020201020201010202010000020101000002000602020202020001010802010201000101000602020000020102020101010001000000010201010000010201010100
02000000020002060102010000020100010007050201020202010506020701020102020100000102020100080102000206010202010202000001000201050200010002000201010100010202010202020001010002020102010000020200000801080101
00020201020201000100000201000202020202010008020101010007020102080001000201000002020200010202020100060202020000020000020101000008000505020101070800010000010001050102000000080102020202060100020200020002
02000202000201010200020202020107010002000102000206060202010000020100000100000202000100000108010101000500010002000102020201080601010007000008050001010700020202020100000100000102000002020706000000010101
00020001020001000100010501010201000002020000010102010108010006020201000101010108000200010101000202000000000202000200020202010108020100010100060106000201010600010800000100010008020002000701010002000101
01050202000002010001020501070000000100000500010101000101010200080201010200010801010201060101010001000002000001020102000100020200020001010200010101010200020002070000010100010200020100000002010102070102
01010000010200000101020202000002020502010001000201010101000100010200070202010101000201020101020001050201010200010101000002020000010101000102000201010202000000010102020001010000020200020002050200010102
02020200000201000006010000000700070200020102020102000100050002010802010100020001010202010202000800020201010201000102020101000601020001000200010202060001010000020000070102010101020000000701010001010001
01000206010007010101020001000200010101010000020202010200010102000001010202020100000000020202000101020202000000020200010006020201000002020100070001010201010101010002000100020100010501010102020001000101
01020202010001000000000100000601000002000001010501000205080102020201000000050200010200000100000000020100000800010202010100000002000102020102010000020202060201010102020002010200020001010200010201020001
02000201010001020102000000000200000708020007000202000001020202020101000201010506020100010201000000020001020107000200010606000202020802020202020501020002070201000001060000060200010200010000010502020002
01020102060106060002080001020202020007020200060101000000000100010006000200010201070102010102010202050100000702010000050101020002000001000802050200010102010602010000020200020202000201000102020000000000
01000100020002000002020000020200020100010205000102000202000206020007000002000101000001010202000001010201060001050201020001010800000101020001020201000202000601020101020002010001010201020101020001010000
02070102010001020200020100010000000106000000000100020200020208010101000102010201000102010007000105010102010200020101000000020200000202020201000501010101020201020002000102010101000202000101060000000100
00020202000000010205000202010007010102010100000600000801020201000001000202020001000000010101020002010100010102060102020001020100020201020201010202020202000202010102010002020201000000050001000101020101
02020201010002020202000101010001000001020200020100020107000001010201010201010102020002000102010100070201010200010206010202020202010001000201060100020002020001010802020202020002020102020701060102060602
00010102020206010002000202000206020202050201060702060201010202000201000100010200010002000202020100070101000001020001020001010000000501010101070202060200070601000107000102000002000002000701020101010100
00010000020101000500070105010201000002020002000002000200000501020001080702080106050006020001000100020000000102060102010100020202000201000002000000010100020002010101010002010001020702010601070001010101
01010200000007000102020202010708060102020202020708080001010000000202000502000201010000020201010102070000020201010102050202070101080002000701020001000102020202000200020101010201000000010802000000020001
02070102050001020000020200000106020102020001080101000002010000010001000200000802010100010101020202000200000000010102010102000101010100000201020101010200020701020700080202000208000102000101010600070101
00010001020200050102010101020001010000000200010000070000010101000102050201000002020108010006000001000802010001020001000100060100010100010001020201020001020100020101000000020000020001010201000602010102
00000008000106020002020602020201020202080200010102020201070001010208010002020002000002000101010102020100010201020005010100010001010201000000010100050001000808010002020002000102020000000202020100020202
00060000010002010000010102020201010001020002070200000201020002000002020102020200000200020002010001000101080105010001020205000201000506010600010000010100000201020100010002080500020600020002020001000201
01010700010702010101020200000105020100020200010800020102010102020000000802020002020200000701000100010202020102010202000002020200000100020100010002020108010001080201060202010202050102020202020001020801
00000200010002020201020001020001020002000002000701000001080501020101000101020002000100020200000002010100010202010102070205010202020000020001010200080202010001060202000001010001010101020501020800010101
00020000020201020101010100010101010601000000010208020207020000000202000102000005020000010801010102060006000102000002010101010000020101020000020005000101050201010101010200000101010601000100010200000100
00020002010200020202010201000000010101020200010202050200020202000001020100000002000002000002020101020202000101010200010001020202070202020002000000020000010101000202020200010101010002000101010001000700
01080002020001080201010102060101050002000001010202010202050001020202010202000202000700000002000000010002000201060202020100010201020200010000010000020200020101000208000000020002020102000200060000000601
01010001000106020201000102020201020200010200000100010701000200020101020102000202010000000001020102010000000100000106010202080105000101020202010100000608020002010100000502020002000202020602000000060101
00020001010100060102000001010202010102010100020000020200070200020100070102000700010200060100020201000102000700020101010200000202020200000001020002010101000202060200080001000102060708020102070200020001
00000700020108010605020200020000010002000202000002000008000200020100000000080600020200010202010100010001020002080101010202080801000105020002050200010001060202010100020101000101010200020200010007000100
01000602000200010202070102020800010201010500070001020201060201020100020600020206000001020100010202010000020101010200050001010002020201020000020201000000050201020101000000010202000001020201010101080102
00010101020101080001020202000100000600000100020600010101020006010002010202020202020201010108020101010001010700010000010700000201010200000202020102020100000201010100000802020202010100000200020002000800
01000202000001010202000102000106000002020201020102010002020000010001000700000102010001050105000102020100000000010100050201010201020501020000070100000006020002020002070001020001000701000601000200010201
01020100020101000102000000080701000202020201010200010200010201020002070201020201000001020102000002000200000200070002020001010202000601010101000108020002010102000101010100070102010000010100000102000202
01050000010200010101060202010200060200020200000000000202000000020106010001010000010207000201000200020100020202000000020002050002080101050102050101010002000102010001020100010706010100010100020100010107
00060202020202000102020000020202000202010201000002070201010801000107020102070202000202060200010201020102000102010202000108070101050000020100060101000000000202010201000107020002010001010201000100010001
00020200010201020201000000000100000201010100010202010201010600020001000201000202000101080001020000000000000100020001010202010000000007010202000202020001000500000001020202020201020202000202000801010202
01020201020002000200060001010001000002020601010201080202000101000001020201000005000000010201010101000002000801060002080000020102000201010200000102010200070001000101010206000107020002000005000102000201
01010200020201020200000000010201060102020200000002080000010100020200020102020106000008020001010100000202020100020008010707000200000100010202020100020108020000000100000202010202010001010202080100020102
02000205080207010200010001010801010001010102020202020001020208070002000102010202020202020208000002020001010201010202020000070000010002000000020000020100070101010201070100020202020202010001020101010100
08070102020102020201000202020008000001000201010201020101020200010001010205000001000000010000020001000200000001010000020102020202000802020002000202010108000200000101010102020100010002020201000005000100
02010201010001000002020008000005010101000601000801020101020201000102010000020000000002010102010001010002010002020501020001000202020201020108010201000000000202010202000101000002010802000700020202020100
02000206000100000002010202020101020101020201000102020101020202020101060207000000000000010001000200010101020802010001020000080101010101020801070001020107010100000001020101000202010002050101010502010200
00020102020202000100010200070108050000000101020202070100000202010102010100010202000000010000080202010001000108010002000502010002010002000200000100010002070000000101010100020101020000020000010006000002
02010200010102000001010000010201010101010202000201000101000200020107010200000202000000000200060000020201000008000100000100010102010208010801000802020601010106010101020202020201000101010102020102020100
01010001010207010208000700020001000101080107000100010200060206000001010201000201010002020101000101000106010001000102010000010802000100010202000600010200020201020202010101010601010201000102060106000200
00010002000202000001000100000201020600000001000502000002060201020001020701000102080200020102020108020202080000000002020008010001000101020006000201060101020002010102020001010102000100010201000202010601
00010101000600010002020001000102000000020102080201020002000101020102020207000000000202020000020201000207020007000101010202070006010101010100000101010100000102000101070200000100010100080201000107000205
01000202000002020000020002020202020001010102020100010002000202020201010100020201000202010000000000020602070206020201020202020202020001080701020202020202020101020200020202010506080101020001000800020001
01000100020100000201000002050100010808020200020201010101010001010000020202000100000001020002010100020802020101010202020207000102070200020202000101000000060002050105020202010002020100020101010008000100
01010201000701020607010202020102060200020102000201060201000605000001010200020000020200020001000201020002000501010000010002020200010001010002020100000200010102000100020101010202020101060202000002000202
02010001020002000201010000010201060205020008020100020200080000000202020102010001020201020201060000000002020102020000010208050100050007000201000200020001000107010002020100000100010006020200000001010100
02000000000000020208010201010100010101000602020102010202000202010100020200010001020008000101020000020100000100010201010100020705010201000100050200020000020601070001020502020102010200080001000200010100
00010001010102000200000201000001000200020500000102000201010100070101000000020101050202010101010101010102010500010202010202020800010201010200010002010102020201000102020001000200000001020106020102000102
00000000000001020001020208010001000002050805010001000102000602010100000102000202020101060001000200010201010001000002000102020000020101010102020801020001020207020201020001020001000602060002000202010202
01010801010100080202000100050101000001020002010000010200010100010501010102000202010005010102000200050000020001000202010802010002010001050001000102010101010001000100080101000000020101000101010000020002
01010002010100010000020102020101010101000000000102020106020201010101000001020800020001010101010102000001020000020102020200000000000002010101010100010000010102020002010801020001010000000201010201060101
01080201050002010002000102010100050108020107000201000202010001080002000001020007010102010100010202020201010601020101080105010101000008050000010001000001010200000100010100020201020101010101000102000006
01010001020100000000010101010202020101070201020501010101010101010102010108020101000801000100010002000102020202010100020208010005000002010205000200010200020002020201000200000102050200050101010200010000
00010201010000020000010002020201000001000100010001010100000202010000020100000106000106020201010200020002010202010202020100020102010200000205010002000100020002010600020002050702000202020101010602020108
