06000001010100000202010002060001010200020500020206000100020200020006000202020002020201010100070000020600000002060101010200000001000202000100000108020000070002010206000005020000020201010000000101000201
00060202000000020100000202000002060100070001010205020200000101000100010006000101080101000201000201020100020201010201010802000101000102000102000100010102020602010007000005020201000202000102010201010001
02020102080802050002020200010102000206000702010001020100020102010202010102020101000702020200020000000101020101000100000100010107000205000206010202010100060002020008020001020700000000020001050100000201
02020108000102020208020008050007000102000201000001010200020108070101080102020002000100060001050101020000000100000001010101020100020200010202020000000200000200060200000001020101010101000100000802010002
00000001010700020101000200000101000101000002010002000201000201010202000102020205020002020005010002070002020100020002050201070500000002050000020001020006010206000000010600020100010008050201000007020100
01010202010502020500010000010202060002060100010101020000000100010102000100020202010200000102020605080001010007010002010100050102020105010201010207000201020202000200000500000102010501020102020101000002
01010100000200000007010201020002010102020000000202020702010005020202000001020602000000000002080101080100010202020200010100020202070001010602000200020202010002000100020000010100010002000801000700000200
07060206010002010100000100010200070100020002020201010700080201080200010000000107020100010002010100020200070007000800000102020000070100010201000200000001000100020100010002000000020601010002020002000000
01020102010201000202010101020102000600020102020102000002010202010000020100020005060200010201080200000100070002010601010101000101020102010100000000000007020201000002010000000201010100010102010506010102
02000001070201020001000000010202070100020002020000000100000201060702010102010101020101060201010201010100020200020001000102000101010002000106020202010000020202000201010000020200010201020202000502000602
02020201010102010602010202020101000102020100020002020002000201020202000101000100000002020002010201070206010100020106020101020001000102000006010200000101020000010106000200000001010202020101020101020702
02000600010100000102010006000102000008010000010100010001010002010101000208020201000201010102000202020002000101000100010202010200010801050102000001020201010000020202020000020201000000000001060108000200
02020001010101060202000202010100000202070200000200000201020207000001020101010101020101000102020101020101000002000200080100020100000202020600020102070102000000000100000101070508000000010002000202010202
02010002000002020002010008000205000102000202010102010101000002010007020101000006000200070102020101000000000102010202010101020102060201010202010102000202020002070005050101010201010001020106020201070105
02020101020002000101010201000100020201010107010200020102020102010102020200020100000201010006000101010000010207000005010201020202000006010006010001020101010001010200020200010606010002000000000201000700
01000201010002010001070106000201000001010100000106010101000101000801010002000201020100020208010702010101010001010200000702000000010000010002010502000201000101000006010100010000020200020200010100020206
01020002000200000002020102010100020102010201000001000101000100020000020002010202020001010102000202000002000206050102020101020001010101020001020007020102000202020002010200010200000200000201000002000200
01010502010101010107010001010001000101010102020002010000020002020100020002020100080701020000020000010505010200010200010002000102020000000001020002020800000000000200010102020001020200020101020200000202
01000101010100010100080202060100010002010200020002020001020101010100000201020102010000070202010000020800020202020201020207000202020202000207020102020000010201020202050100010101010002000100010102000001
02010000020202020106010000010200000001020201000202010201020202010200000102010102010102010101000102010600000200010201010602020100010000000202000201020002000002020001010101000001000201070201010202000202
01010600020200010100020201000002000202010202080001010101050201020102010201020200000200020000000200060102000001010107000806010000000201020100020202020000050107020006010002010002060202010001000202020208
01010201000102020006000001010100000102020201020500020201010101020201000202020200000205000200010000010002010000000202020001000200020200020201020102010101000101020001080102060000020000020101060001000000
01010202010200020200020101010007020200000100000100000201060100000001010101000101000001020002020201070100020201000001000100020000010202050007020102010202020201080200020200010502010201020102020201000200
02010602060101000202050201000101080202010105020100000100000101010000020201020100000201010102020002050001010200020000000200020101010007010201020200010200050601020201000202020201020001000200000002010001
01000102020000000000000002080001010001020101020700010006000101000000010000010101010100010001010101010101000202010107050000020600020202020201000201020001010101010100020101000100010002010002020802010201
02020000010200050001000202010000020202000202000102010102020002010000010206010202010600010107000101010201060000060202020102000506000201010200020102000102010001000000010000020002020001020002000202010000
00000201000201080002000006020101000502000100080100060201010101000202020101020102020205010700010502010002020000000102020101000101020202020101000207020001010201080001020101020200000101000001020000020602
02020202020200060001010001060208000201020001000801020200000202010001020001000102020202000200000201000101080101010201020205010100000201020200000101020201010000010102000202010002020002000001010200020100
06000602020001020200020602020102010107020100020200010200000107020005010002020701010002070002010201000000020102020101000206010002050100020202020002000802000002020201020000080000050202000006010607020002
01060208010101010600080200000000000202010000020101020106010001010007020200000102010002020108060002010101000001020801010101000200010102010802010501000002010001000001070202010102010200010001010200020200
02070802000201010106020202080100010108010000080006000002010108020100010102000108000200010101010101000005020002000002020000020000020202000001010000050006020108000002000200000200000100010202020200010001
00000102000100010202010102050200020100000200000002000005010200000000000601000200020202010102060200010201020202000101010002010201020202080102000102000101010100070100000602020000010101070201010207000101
01000001010008010102000202080202020001010101010100020201020201010101020200000202020202020000010200010200000500020005010002010000020002080501010001000000010100020001010001020002010201010202020208020101
00070102000501010002000001050201010101000200000200010002020000020008020205010200020101020101000202000201080002020102010105010000020102010100020201010001010102000102080201020101060005010000010000010001
01010101000202010002010002000002020002000105000201000002000201000002010101020000020201010100010102010102010000000001020106000102020200020500010200020000020700010000010201000101000001020202060102010201
01010001000100000600000202020100020600010102000202050102020002010201010006020107010202010100010202010107000001000100020201020706020200010100010701000201010000010200060000020002010001010100000100000102
01080201010205000108000001000001010200020000010001020200010501020105000200020200000201000102020207000200000200000001020100020200010102000207020201010200000201000200020201070100010101010100010201010106
02000107010205000002010000000102010000020101000201020201000506020002020000020200000802020201000002020000020002020202020102000200060000010201020001000006020708020002000201020002050001020000020100010100
01020002070002000202020001020002020201000005010001010102000202020100020001010101080000010101000201010108020100020106010002010207000002000001000202020200020100060200000002010002000002020008010100000006
06020200050200000102020200010001010101080001010000000708000100020101010101020000010501010102010000010808010000020000020100020001070002010201070201000101010101000201020601020201010102000100010002000100
00020102000000020701020000000002000100010105010100020100050200060101020001000200020002010101000002020100000201000201000201020200010200000200010102010700010500010000020002080000000500010101010202000206
00000001000200000201000202000101000202010007020102010101020200020501020200010200020200010101010200020002020102020002010100010000000102020201060100000100020102020102000102070200020100000202020700000007
00020800070101000200010102000206000201000101020200010100000202000001020208020000010100000107020202010202000000000102020108020101010102010101010200010202020200020000000002020601000000010102020102020101
01010202020001050200060001000000020202020102010706000000020000010000010000000601020202020202000106020001020001020000010001010101000105010001020000080001000200020200010507020100000200020101050100020600
05020200000200010101000202020202010101010102010000010102010006080802010200020200000100050107010000000502010002010102010108020102020101000200010201020200000202010000020201020108020006000600020207000102
00010201000101020101010102060100000000010200070102020102010002010101020001010101000101010201020007010002020200020108010202050107000202020200070501010001010200020001020205020200070101020202010100010002
00010000020102020100020100000101020201020102050002020802020102010200050007020101000202020500000201000002020102020501000201010201000001000100050100010201020000010100010202000100060202010100000107050205
02010601080601000102000000020101020000020002000001000002000100050002000202000201010202020100010002010201000207020502010101020001060005010102020000010800010102010202000208020205020700000001020001000706
02020101010201000802020201020001020100010001010200020001000600000200080501020500020202010202010201020200020202010206020202020701000102010100010806000000000102020100000002010008010201010002020100010102
02020200080202020101010002010001010700020200060101020200020200000206000000020101010100000201010000020000010100050002020001000101000000020100020702020001020100010000010206000002010200060102020202020201
01020101020001020000020000000200000002010008010201000200000201020202000205000101000207010007000101060201000101000000020102080202020202010201000008050001010000010000000108010802010102020102010502000100
07010001020001080100010202000208000005020102000002000101020000000202010102020000010102000101080200020001000200020002020102020000010006010601000102010100010202010606010002010000050201020100020101020002
01020000010100010000010202020102020202010002000102010002000000020002020102000100000102060200080105010202010101020602000202020200020200000001000000000001020008000202020201020205080202010201020100010202
01010201000802000000010000020000010101020001080102010501000201020801020001020101010201020101020200000200000102020000020001010001010502020102010001020202080101020000080101060002000600010002000107010002
01010101060102010002000001000100020101000006020002000202020002020001000102020100000200020007020001010101020200010202010107000008020100000101020101000102010100020200020100000600000200010001020102020106
00000102080606000206010201000101020202080202010000000200020102000101000202000601020101010001070100000101010000010008020007010002020800020200050102020206000000000201000200080600000100010002000001010201
01010202000500010001000006020200020000010002010105020100000201010102000200010002020200020201020201010005020100000001020201010202010107020000010100000100010100020101020100020802050200020200010101010101
01060200020100010101000102020500060100010101000100070001050000010100010100000001000202020200010200000101020205020000020200010002010106020200020001010100050100000201000100080102000101000100020001020001
01000200010200080102000200000100000100000201010802000201010100000201000002010501000001020001000201020602010702010202010201010202010008020000020202020201020100010000020102000100010200010801020200010008
01010201010101010600020202070101020200020101020000000100010108000201000102020601020101000101070200020001000202000202020102050102060000000100010000000502020002020001020001010802000000000201010201020101
00060000010100010008000000000002020101000202010200000001020101020100060102060001080102010102050701020201020001000202010201010002000101050001010001010102010100000000010001010202010101020101020001000000
01000107000202020102000102010100020700010100000200020001000000020000000101010000000200020102000100020002000000020201010001000101010001000101000006010200020202000002010001020101020201000100000105020807
02020702000100060000020001000201080006020202010202020200020001000100000002010005020001010102010102050201000001070105010200020002020001010001080001000101020101020200060002020007080100000200010108070000
01060200020100070001020000010201020100010000020102010000010202050201020001010001010100000200060101010700020200000100020101000000000602020002000207060102000006020200010200010100060202010002000000020800
00020201010202020100020001020201000101020105010001010702010002020101020700050101020002020001000000000201010002000102010100010002000002010601010000010000000102010602010100020108010206020001010100050008
00020000000001010200020201010202010000020100080201020002020102000001010101000000020202000201010700000101070000010201000101000600010000020202010101010102000100010200020500000202050108050200010200080206
02010100020207010201000002020201010102010101000001020101010000000001000001010206010200010105010200010102020102000108010001020001010201000201000207010200080201000201050008000200020701010100020202010101
01000102000005010100020100080101000102020202020101020100000200010201010101000007050102010100010002020000010200000101010000000202010202000002020000020000000102010000010002010206000100000500010000020602
00010102010100020100020000010001020005080101000207000102000001000102000200010201000001000002000000000202010102000206070201010800000002020106070001050107000102070701000102010102020002000100020201020001
00000002000201000600020101020001000202010200000200020100000002020201010100020102000001010001000100000100000201000002010800020200010102050202000101020101000102020100000200020002020702010202010000000201
00010102020001070202020200010100070000000001020202010001010200020201010102070502000102010602010200010002020207000102060102010101060000000200010100010002020001050201010002000000000101010500000202020102
02000202050200000000010206000100010100000002000002080100010000000502020700020002000002020201000601000201020202000002000101010201020101020201020201010200020108050002010102020001050102010100000100000001
00010101010002010002060102010001010208020001010200010501010101010201060001010102080208020002020200050201000202020600020000000100020800000002010108020101080202000501010200020802020100080001000000000200
01020002010107000002020105010001000202060200010201020200020001000100000200000100000102000202020200020100050206000102000101020202000502020801000100010202000000010101000500070102060101010107000001060001
00080001000000000101020101000002020001020100010000010102010102010002000101010001000100000000010100010101020202010202020200020100000102020002010202000101000002020205010202000001020602010101000002000000
01020201010200010101010200010802010200020100020202020205020100010000020202020700020001050007000008020201010000000108000501010001000201000002010101020100060101000102000101020200010200020000020102020001
00000701020200000001000201000202010202000102020000010000000002000002020200080601020000020601020202000108000102000001010801000000010202020202000102060102020201000101000201020100080202020200010201000205
00020101080201020205000001020006020006010001000202000100020700010601070201020202000001020200010102020008020202020200020001080200020000000001020601020000010001050001000201000100020000000202010001000002
07000101080200060002000101000000020000000202000201010007010108000102020701010001020500010201020002070002010101010100010002020001020206000202050102020100000000010101000101000602000002010001020105050500
02020000020002010201070000010202010101010001020201020101020500000200020202000100010201020101010101000101010101050101020108000100020001010102020001020102020101020107020200060200010501020200020201000007
05010002010100020605020802020200000101020002020700010100010102000000010200000105010101010002000002000001010100010001020201000102000101020001000200020101010002010500000802010001000000010201010000020201
06010200070200010206010102010202010200020001000007020200010200010202000000000101010100000202020202020202010002000200000201000002010106010001010201010100000101000201080207010200020001010100000606010202
05000001060100020100010006000102010201020200000102000500020101020201010200000200080002020000020202000001070201000600000201020105020100020101020100010000010100000202050000010701000101000001020201010002
00000200000101010002020101010101010000010002010000010000020102010100000102000000020501020202010200000201010001010201080000020102020200010202010102020201000208000201020200010206010000000200000100000001
00000206000200020501010202020200020202010202020102020102010000020100000207010202010000020001020002000001000101070002020701000000010500000102020801060102010102080001000201000105060200000201010201010102
01000201010001020202010000010001010102020502000001020701000100000001010100020000020100010002020001000001000007010201000000050201020201000002000201060100020201020102060000020101000202000007010202020202
01080101020202010202020700000001020001020802020100020000020202060001010001000202010102000101000002010602010101010107020008000202000001010202050601000200020000000201020001080201020002010100050202000100
02070201020101020100000202010202000001010202000700010202010200000101020001010102020102010202000001010000010207020001000201010202000501020502000000010201020105020100010000020000070501010007060200010200
01020101020201000101070102010100020200010201010102070001000102000200020005060202020005000000000000020001020101050201020102000007010000000200020200020200010800020002000102010201010202050201010500000202
01010100020601010201000202000101010800000001010000000100020202000107020101050501010202010200010102000200010101000200000002010002020102010000020201000802020202010001000802000006000202060208000100010200
02010001010000010702010201000102010002010201020208020502000102010200020101000202010202000002020000000100010100010002000205020101000202000000010002020000000002000000000208000101020200060000070100000001
08000102020000020202020208010801010000010200060201010001020200010001000101020101010002020201010100020202000002000205020000000001020000010102010200020202010201000101010002000201000100080101000600010202
00000701000002060200000200020002010102010506000200000101000000060801000000000200010001020100010201010101010101010100000202010202000100000101020202020700060100000201010001020202010000000202010202010101
01010001000005010001010001000100010201010200000100010101020101020202020101000000000101080102010202010201000000000200020100000100000200010202010207020101010002010101020002080200000002000102010102020200
00060100020201080200020200020002000101000200000100010101080200000101010106000102020107000108020002000202020502020107020001010000020002050201010502050102020100000102020002010206010202020002000201020701
02010202020200020201000102000102010202020002010101000200010002020101020100000701010000000200010202050700000002020001000002000005000100000201010202000201000001020202000102000200020102020202020200010001
01000002000205010201070601000008000002000502020202000202000100010106010001070002020001000100060001010201010201060002000101010200010201020101010202020202010002020202020202020000050101000000070200020100
01010000020101020200020700020201010000020600010102020100010101020000020601010101000201020100010206000102020200020801000001070202080106080200000100080101000701010102020002080101020801000700000000020106
01020201010202020000010002010000010201000200010001000200020101010002010101070107020200020202010202020202000101000700020101010102010701000007000101000101020102000200000101020100050100000107010201010701
02020101010102020101010202020100020202020501000000010000000207010002010000000001020002000002020001000702010006000502010200050102020201000002020200020001020000010202000202000001000001010102020202020502
