02020000010202000801010202080202000202010001020602020000000200000206010000010101020200010106020102020001020101010002020006000001010001010101020801010000010002000601000500060101010201020005000501080201
01010000010201010002000201020501000100000102060100000202020000010102010000020000050108010100000702000600010100020201000000000202000700010101020108050002010101010101020001000501010202010100000001020100
02000807010006020102020701010102020202000201010102020100020202080701020200050200010101020000010002010202010501010100010102010001010200000001050102020200000200010507010800070100010001000005000100020000
02020202000201010000000100020000060001000501010102050002000200050102060101010801000000010001020700010001000002020501020702020201020000020000020200020101000200010100010202000201010102000701080207020202
01000001020000020200070100060701010002010500070208000002020102010002000008020101000102000102010002000102080000010007060106020100000102020201010101020200020201000102020206020100000000010502000000000000
06020201010100020002010002070207060700020200020102020202020100020700020201060000020106000102010002020202000001000202010000000102020200010200010100020000020201000102020205000002020102000201070002080101
01050100020000000001010001020001010001000002020101010102010201020200050201000000020202020200050000050100020101010001000002000102020201020200020007000102020200060002020100000700010005070001020200000102
01000102010102000000010101000602020001020202020102010101020000000200060102000101010600000208000206080201020102020102010000020708000206000000080200020102020008010200000006000000010100010202020207020100
01000002020202020001010102010001010002060208000106050101000000070101000101000001020001010000010102010102020001010000000501010007010000010101010200020200000001010001010100010002010201050202010001000002
02010001010201000000010601010100000100010802010700080101010001070002020100020100000100020200000202010100000000000102060002020001020101010002000001070202020201020200010101000002070101010702010001050002
02000202010200000202000200010102010205020000010102010000060201020102020201020202000007050007020208070105010002050100020201000607000102000702020202010201000102020200010101010002000101020501010201060201
02080202020001010102000700010108010002010202020101070002010100000201070202000202000100010102010802020000070101020001070000020000010201010002010201020201020000000202000701020108020100010000000200010708
01010001000100020201010200000001000201020100020201000002020202020201000200010802010000010202000200020202010500000207010101020700000101060200010201020101020101000007010201080202000102000202000100000201
02000200020101020601010001000008000602020102020202010002020200020102060101020002020200000202010100000201000000010001020201020000000200010202010100020001010702010007010101000102000200010002000702020001
01000105020002010000000102010200020206010205010001000700010200000100010001010101020007000202000200020200010200020002010201020000010200020201020201020606000201010101020001020001080102020600050102000200
02000200010202020000070500010202010200010107020202010001010000000201020102000101020201000200020101020000020200070000000002020200000101050201020001000106020102000107010701000201020002020002010101020005
00010600010002000202010800000001080702070202010101010000020702000000000002070002010700000101010000020202020102000202010801010106000601000000010001000102000001000001020201020202010000000002000101000101
00020100010000020702000101020006020502000606060200020700000201020002010105000200000700010107020000020808000000020202000200020706010101000201020201020000000201050201000600070202010201010501000205010000
00010101010101000102020200080006020602010001020101000101020202020200000102000001020002020702020002010202000200000001000500010700000602020102010000020100010002020102020502000000000700010200010005010101
06020201020100020100000201010002000102020108010202000000000000010002000700000701000202020002050601060000010201020102000002000101000201020601020102020702010000010802010000010201020202000100060001020200
01020100020802020202050201010201050100070101020206020602020001010702020102060202020200010108050801060102020801020201020101020102020002010000020802010201010102080000010102000001000102010000000101000102
01020100000202010101000000020002000000010101070201060802020001010001070101010100020100010100020001010100000001010000000605000001010107020800000001020008020202000207000008020201010002020002010005000105
00000000010000020201000201000002000102000101020200020501000202020102020202020102000100060200010101010002010102000108000102050201020006020200010102000200010002000102020206020605000200010101010000010000
01020202020001000101010105010100020100010101000200020102010002000000010000000102020001020002020002020200010202010000010202000102000601020201020606060201080002050000020201020001020001020001010100000202
02000507000100010601020000000501070200010002000200010201000200020005000202020101010001010006010001000000020101020202000201080108000100010200010201000201020200010100010002070100010001020201010101020001
00020002000000050101010202020201020002020102000102020001020100000102070006050202000001050201020500020101010201020000000202020100000101020101000000000000010201080002010001000106020100000000020002000101
07020005000200020507000202010206020100020800020100020101050002000101000001010202010002000101000000020201010001000802020000000102010000000101020602010201010000020101020001000100020102000500000101000102
01020201000201010200010600000001000708000200010001010701010805070202000000020500020200020002000000020100010202000106070100010001020700000202010201000100010102010100000200060102010102000201020202020100
01020102010200020702000202000100000106010206000100000001060201050201010200000600010200050001000102000201010101020800020001020102000201020205000602010601020102020706000101020202010100020201000001000002
02010101080201000500000101020108010101020101020002020002010001020202020102000002010600070001010201020001020007020802020002000100000200020100000002020001010101020000000102020201020200010200010002010000
00010202000000010002000100020200000602020202020106000002020202020101000201020101020502000102020202000200010201000100020200000201000000000002000102000201020200020001010205000000010201020700020106000001
02080201010102020000000700000202020002020206000202020802010001070001020000010201020100000201020102010102020201070100020102000005000200010002000200000100020201000201010200000805000201070201010102000001
00000200010202010002010102020202020102000501000205000102060201000802020202010100050202000000000000070600000106000002020008000201000200060205020101010000000001010202010102010200010202000101000701070200
02050100020200070201000201010100000002060002080101010200010802010100020100080208010105000101020500020001060201000200010002010105010202010002010202020201020202010000000200010000010801020000000200020205
00010002000202010000020202020001080102000206020100000102010101000201000200010200010001000102000100010802070000010207010101000006020001000201010600000000020102020602010101020701020102010201020000020002
01020200000100020105010202020002070501000102000002070201020202020202000200020001000201020000010000000202020101070500000102010100000101000102010200020200000200020200080002000001000100010000000002000100
01000801020000020000020102070201010001020101010000020205020001020600020102020101020801010000020500000200020000000102010000020200070100010601000101010006000201020201010202010800000002010100000002080105
01010002020000010101020001010000020202000602050002000200000600000105000001020001020801010201020002070200020100000202050100010201010101010801010201000208020001000201010502000001020001020001000801060200
02010801080102010002000206020201000000000007010008010201020002050202020101000100010000000500020800020001010201020100000202020000010002060000020802020002010101000102000102020800010507020002080001020202
02020200000201010100020101010000020002020100020201010008010202010000020200000002070001000101020000020007070000000100010102000102000002000000020201000201010001080201020201000002000002020200020001020201
00010201000102020701000000020200010201020202020001060201000801000200000001000107010002010000000100050802020000070102000201010001000700020102010101020002010201070802020002020001020102000202000100010202
02000200000100020000010202020108010101070200000002010102080102050102060202020202050201020002010501010207010200010801000000020802060100000100010100010106020102010000010002020707020102010501010001020202
00020701020101000001020102020200020200070101020100000500010000000100020201010602010208010602000000010700000000000200010801050207000000010101020201010002000200070102000102020002020200000200020000000001
02020000000100010005000102020200000101010100010200000100020100020001010001020001020001020002070101020200010001010601020100000102010202010000060701020001020100000202010002010008010702010202010207000200
00020200010202020202010102010800010100000002020001000001010102020100020202010202010102020201000101020001020101000100010101010007010201000002000002000101010001020102010100020000010102010007020101000202
00020202020502000002010202010200000000020101020101010000010801010102020002020102000601010102000201020101000501000000020202010208010006020101010102020605000601000100020000020001080600020200020100000800
02000600020201020101000200000000020202010802020101010700020000000000080701000002010102000101020102000200020002000201020200000107000002000100000200020202020002020202000101020000020000000701010000010000
05020101010202010007010200010202020200020100020201080202000101000201000000010800020001020600010600010101000201010002010201020202010102010008050502010002060001000000010802020200000202020002020002010002
01020802010000010102000107020108010102000102010005020501000000010000020607010202000100010101000001000201000101010101020001020002000001010100020100020101010200010101060202000202020200010001000102020001
00020100000001020101010005020200010202000202000202070105020206010101010701000600070106020001010002020102010001020202010100000002010100020701020001020200000202000202010002020000000102010206020102020202
02070202000101010000000701000200010201010101020100060601000106020501020601000200010201020000020000000201000100020100080101000006020000020601000000010000000000010100010005070102010002020800020001010202
02000200010001010201000100010100000100010200080000070001010802010101020200010501010100000202010202010100000201010101000101000108010100020001010002010100020000020002010000000000010102000102020101010101
02070102070202010501000201010201020102010201080102000100020100020001000201020001010700070001000201070202020201000200010108020601010002010202020102020000000208010101020006000001010102000201020002020100
02000100020201000106010000010202080101000202020202010001000102000000000001060201020200010102010201010205010000010800010102020702000100020500020801050100000008000005010000020202010200050102010202020206
01010101000202000001010200010101020002000000020000010202010802010200060102010002010106020201020100020202000100020100010102080200020602010800020000010107000200050202020002020001010100020100020100000206
02000200020006020201020002020101020002070002050007010002020100020600000107020001020200010100010100020202020200010202020200020102020001000002010801010205010002000108010000010001020001020200020200000201
01000202020202080001010001010100020800020602020200010101010001010102020200050502010101000100010000020500020000000101020102020001000100010100020000010600010100010501020702070102010201020201020201010202
02010202010201000600010000000001010200010101020101000101010002050106020102000002060001010200010201020102020102020001010205020802010105020002010502000101020200000000010002010101010202000102000002010200
00010102000201000000000000000100010100010000000202020005020002020000060806010106000605050100000002020002020101020005010100020100000101010102010002000001020102020202020100020102010201020000000202020101
00080202010602020101000005000201050002010007010100020001020201000702020202000102010101020000010002010102010208070001000002060201020701000001070101020202010002000200020101010200020102020100010205000002
02010202010001000201010205020001000000020100010200010007000100020000010202020000000002000702020000010106000206010101000201010102080101020702000102010202010202000201010200010000000002010802000200020802
08010001000100000201010207020002050102010100020502020002020000020802010107010002000200060102000000020501010202020001000800000005060001010100010207020101000201010200000206000500010000020002020000020100
01020101010101000005080100010202020101020101020701010201050201000001010000020101000207010101020105020201020201020201010100020608020200020001020101000200010100020501050000010200020802010001010202020801
02010202000101010102000200020102000207070202020102020102020101010102000101000102000001020008010202000202020201000102010200000007020000020000070201000100000002020801000202010101020002050100070200000000
01020202010601000000000001010001020102010002070201000002000102020002000101010001050002000101020201010100000002020002010201010002020002010101020201010202000200010201020207000801020105000005010200020205
01010100010601020105020106060002080008050205010200050100000200010108020200000602010202000002000002020002070202060201010700000000000200020106020202000001000101000801000201000002020001020000010200060001
01010701000207000100000102000801050000010100010002000201020200010002010102000002010106020102000202010102050202010100000207000201020002010102010201010101010102000500010108010202010201010102000502020100
00000001020100020107020101000105020100010100010202050001010200060200000102000107000102000008010701000108010201000001010201000001010602010101010208010002020200010101000201000100010002020202060200020100
00000100000202020200010008000000000002000000010000020702020002020002020102000500020200010205060101010100020100000602020102020002010102010200000201010101000105020101010102020102020005010105060000000202
00020102020201020001020100010002020002020201060201060202060002050002000102070200020102000101010200020101020601010101010202010101010801010001000701020200010100000102000102000102010100010102020001020102
02000102000202010100010000020502020202010000000105000702000202010000020000000200000000000206020201010200000008010002010208010101000001020202000201020102010802010100010102000100000100050207000002000100
00000202000601010800020105080001010102010700020201020202000702010101010002010001070602010200010200010202000000020100010002020001010100010802020202010801010202020102080202020101000100020105050205010107
02010105010102000000010102000702020101000202000202010101010102000502020002060101010202010102050201010202000202010102020001010102010105010200000002010002010206010200010100020002010101010201010201010101
02010102010002020200010101020605000001010001060702020102000000080001000600010200000202000002000100020000000100010002020601000002010000000100000107060000010000020200010001020202020206010200000202000202
01060201020205000102000202020102000100010101020202020805020101020200020500020102010201020000000100080000000001020000000000020208000001000100020102050100000002010101060101000001070002010201020102020202
02020201000002020002020002020006020201010002020200020802000000010202020102010202060000000106000002020001050106050201010208020000000206020702010201000101000002020100010202010801000502010002020000020200
02000101010001000601000200020200000100000202050002010702020200060202020101010001010200010000020201000006020201010106020102020202020001020002000500000202000101000201020100020707010602000100000201000200
00010202060201050101000200080101020102020000000500000101010100000002000202010200000102010000060200020102020100000102010100020002010102020202010102010000020000010001010100010201000200000001020102020002
00020202000102000202080000020201020002000102000200010201010102020002000201000207000101010102000001010201020008080207000000010102020200020102010201060002000002020102020001000202010001020001000201010805
00020002010002020001000205080702000002020201010000010002020201000100010001010201080002050202080200000001000201020102010000010101020000000002000002020205000000010101070200000101010207010202000202020101
02020201020807020002020100010001010802020001010101010201020100000001000001060001020200070100010202000000010202010102000501010200060202000200010500010002010200000201020001000200010001020102020101000001
01070701000100020100020000060200020107010206020202000002000100020200020100020201070202050002010001020205020102020200020002010002000002000201020201010205010701020201010001010101010002000001000102020000
01000200010201000001010706020201000100000100010005010002020600020002010702010002010002050001020202010100020202010001010201020101010101020100010207020200010600020202020100050100020002000502050101060102
01000201020201020000010101010006020100020101000200000001020002000000010001000100020007010007000500000202020502010102020206020701000000000007020101000200020002000200000200000000020102010202010102000600
00010002020002000007010102000202000200020202020201000002000002010202000202000001000202020202020001000205010001020202010201000102010101000102010101000101010000020201020000020000020206020001010000020202
08020100010102000200010102010001080100020201010101000002080000010201010001000001010001000200020201010002000200000202010200020001010001020702000000020701010102070200000100010107060702010202050200020201
01000201010601020101020100000806020206000202020001010501020001020001010802010100020002010201020202010001000108000102020100010107010107020100010002000100000200020001010001020101000001010101020202010000
02060102020200020101000200000000000200010200010000020101020002020200020500020701020102000002000001010001010501010102020001050202020101050200000602010002010205020001000001020000000001020102010002020207
00010200000001060001010102000102010102000201000000010602010200060202000002020200020001000502020001010001000005010002080002000208010000010502000005020201000208020100000202020200000100010001020001080600
02000008020002000101000100010200050101000105000002010001020001010107000001020100010202010000060101000200010002020100010100060202020001020202010500000000000201000000010200000002000202010002010000010201
01020200020602010201010102000101020002000100000100010600000002070202000202010200020101020001020207070101020101000001020108010202000001020200000202020100020000000000070001010201020002080501000202020002
00020001000100010102010200010205020101020002000202000206000201020602010201000101020102020102010106010201010600010201010000020100010202020102010208020201020000010202020208010202010201000202000001020102
00010101010802000201020000000001010000020202020002000101000102020200010102010001020002000101010002000000010500020001020101000101000207000502020002000702000000000202010202000100000001020000020000000200
00000202010800020101000202020202020002080000000202070100000101000701010802020108010201000002010102010100010202010001010200010201020800010000010102010002020101020101000200010701080202020100020002020200
00000000010102020101020106080000020100020700060102000202020001010000020100020000020200000102010002020100020202000201000102020201010005060101010006020100000002000002020000010208010202020100060202020001
01000000050002010000010000010201000702010102020000000101020101000000020501010201010201000102010007010101020201000801000000010001010100020202010200010102070201020101000200000806000100010102020201000100
01080201070101060001010800020201010000020201020202020102020001000201020207010700000202000102000207080002010106000100000102010001000201000000050002010000010202000201020007000101020000010200010205010202
02000100000002020100020200080100000608010102010001010106010001050000000002000000070207010200000006010000020001010101020200000108020505010001000502000202020202020102000000020000010208010100010201010201
00070101020007000102020602020002010600010002080200000502010202020101020201000200000007060008010102020100020100010001010201000001020100020002020100010200010005060200070500010502020202020105010506010001
01000002020201000002020801000100050100010200000001010000000000010102000101010006020202000002080801020102010000020105010002020102000202010202070201010202000001010101000001050000020102020002010000020101
