01000100010100080202010105010202020102000002000100020101000200020000000000020102000200000201010202050201010001010001020202060602080000010000020100080202080102020102000202010101000106000602010205010201
02080102010007050200000201010202000002010000010002020202010202000201020201000101000201010002000000000200010000050000020202020200020102020107050202000002010001010102000105050000010105010002000201010102
02000201000000050005050102010202060200020101000602060102020002010001000002010002020001000200000201020006010201000207020201000702000002000200000202080200000200000201020200020702000101000005010702000100
00020607000200020001010000010200000202010200000702020701010001020006010006010206020501010101010201000002010102010202010208050101010801010007010100080001020202000001010000010202060005020001070200000702
01020200010202080102050501080001000201010002070102000600020100000101050107000002020801000000010100000201010000010101010002000101000102010100000002000101000102000201000202010102020208000002000001080800
01020102020200020005000101020000000100080201020202020002020200000106010102020100000200020102000001010100020708000100020202000201020200000100010002000001000202050002070100080200010102050002000102000102
02010101070502060201080102000005010106010201020701000202020206010002020602000101020000000202020101000200000206010202010100000202020200000602010102060002010600000200000100000000060201010105010200020200
01020101020102020107000002070002000202020102000002000200000000000101010601010202020800070202020101000101000202060002020102070101000202000101020001000202000201010102000502020001020201010108080102020508
00010000010201020201020100020005010200020102000100020000000501010201020202000200080100010207010007010200070502020101020101020005000002000102010100020008020101010202010100010202050102000100020002000200
02010200020501010200020100080008010201080200010202010000010201070207010107010001010200020507020201010200060200000502070502020102020002000200020100010200000201010202010205010202020000010000010002020201
00000201010000080201020102010202020101070201000102010005000007010101000701000101000002010201020202060002080000020101000002010100000100020002020200060200000700000501020707010101020200010200020202020208
00000101000002010200010101000000010605010202010201020000000200000502020202020701070202010001000105080106010202070201020800020201000801060505010202020100010002080101000102000002010000010602020700020101
02000000020200010001000201020001020807010602000200010205010001010501010002020000020100020100010000020101010102020201010200010106020101000000050101020002000102020701000100020200000002060000010001000501
06000702020200020006000101000202020001000001010001020607020002000002020207010101010202000002010102010001000000010100080002010000010202000006010202020202000002080102000202000101010701020201020102020002
00000201020502000000000207020001020102000102010201000002010501000102000101000002020106000100010801010102010200000001000100020100020002020101000100020102000200000101000102010602010101020106010002000502
02020101000200020201020000010001070101060002010002020001000102000002020600070201010601010102020100050501020101010001020100010501020000000202010100020100010002020700020500020201000008020802020000010200
02020102010100020000010801060100000100020102020100000200010000000001020102000101000000020001000501000101000202020101010200000001010502000108000101010100010100000002020202020002010101020200020001010001
02010102060100010102020100010000000207000002010102000001020202020002000201000101050100020100050201000001000101000201000008020201000208000200000008020100000100000102010701020102020100000002010201060200
01000101000802020000000202000106000000000001000202020000020202010101000507010201000101000201010101010000010000020002020201000200010200060102010100020106000101020001020000000102080102020800020000000800
05020102020102020000020100010101020008010001050100010101010005050102000001020001070002020101000201010007010002000001010200000100000002010102010801010102000105000200000005000108010001020102010201000000
02000502010202020100010102020101010102000200020200000201010101010002020201020102010702000202020201020201010002010002000101050100020100020102000000010200020101020200000000020200010101010100010001020202
01000002080201020505000202070102000802000101000100020200010000020202010102000208070100010100000601010000010800020105080202010701020100000600020001000101020202020601020208000202080100010202020600020200
00020201010101000200000601010502010101010201010002060002010100020102020002000207010002000000000502070002010501000202000201010001010207000100000000060200010006000001020205020201020100000008020102020005
00020202020000000102000202050201010000010200010100020700020001020200070100020201010202020501000101010101010001070002020101020000010100000102020001000008010200000201010001000001010200000102010101010002
01010108000100000200000002020002010101020100010200010101000002010001050001010202000002000001010101000002080101000202010008020201000000080802010100010202080002010200020102000202000001020605020202020200
02020202020200000102000002020201020100010100020200000001010102010001010008020202010002000000020000020201020200020200010200020101020102020202020201010202010101020102000001010202000101020100080000010102
02010002020100020007010101010602020807020002000002010001070002000208010102070202000102020202010000010200000101020102010200000002020002000600010002000002010001020000020001000001000002000000000200020200
02010002020100020005010102020702020701010001010200000202010000010701000201010002010208000200020000000200070002000002020100020101000102000000000000000008010000020001010207010002020200000201020002000000
00000500010000010101010101000206070602000000000202010101010200010100020202000000020208020108020101010000000100010001020102020600010101000102010002010100000201010001010002000002010202000000000202010008
06000200020701020001010202020000000502020101000100000206060201000101010201020102000102010000070101020001010100010200000000020100020100000102020002010208010100060101000100060602020202000607020007010101
02010201010702000200020100080100000102000201020000000202010000000202000102080506000200020002000000000101000101010200010100010002010002010201000200000202010002060002020002020701000600000102010000010202
02010202020101000100000802000207060202050002020102010105020001000002000100010600020200000207000501000101010500020100000000010002000200070002080002010002000100000000000001010100000000010000020000080001
01010100010000010701020002020200020102020006010701020801020002010200020000010700020002020101000200020100010801010200020000060202020707000002020001000001070201010100020201010202020005010106010201010201
00010001020101080101010605020206000001020000020201020200020202020701000005020002010001000200010102020102020201010002020102010001020002010202000101000100020801010001000201000000020700010202000202000100
00010102000002000701000000010101020206010001000600010202020200020200010200000002000102000102000100020201000001010208020100020202010101010102020101000001000000020200000001000002010001010101020108000501
00000201020600020601000501000200000201000001010101020600000101000200010001000002000202060201010101010000010201010002020201000000000001000202020001010702000001000001020705010100010201020802020102020101
01010100070002000502020201020100070100010105070202000200020002020102000100020201000002020200010207000201000101010107010100080102020101010506020101020200060102020100010202010201020001020000020102010202
02000101010101060200010200020000000202060002010000050000020102010101020508010200010101070002020102010000010500070100020101020000010700010007020208010102000000000206010001000002010006010200010201020007
02010101020108010101000701000202050006020100020100020102000602020100020202020202010002020101000002070000060102010206000200020202010102000000000101010101000201010001000002020100000102020000020000010001
02020202010101020802000500020200010001000201000202080102000201000501070705000200000102010802010201020100080002020106010000020100020202000100010001010201000101010200010600010201000002020007060000000202
02020201020202020802010201000200000101020200000202000100000200060200020202000101010000060000080201020707000002050200020202010600080102010001010202000100020008010102020101010201000002020100080102020101
00000102060201000001010001010201000002020002000002000200070202020000050102010005000100020002010001060102010101010102020002020102000002010100020106020102020102000201010202000200050102020200060101000001
02000201020508010005010002020201010002000002010002000000010702010002010000020101010007000001000001020000070100000200020101010800020202000001060202000102000202010200000601010201010100000201020101000001
01000002010007010201050002020207010201020202020100010700000101020002010200060200000200000000020802000000020100050100020000070102010201010001000102010101000202010701050002010102000100070201010101000202
01020100020201010000020101010200010601010002020000000200010201000101010102000200000201000101070002020000020108000202010002010000020001010606020002020000020200020102000000010102000607010000010000010200
02000006010002000008010002010101000202000000020102000202010100020101010200000002010007070101010000000102010102010200020108000001020002000205010001010102000201020200000102010001000100000201000001020601
00020000020801000102010005000002070001000007010601000205010102020102020201020202000000020201000000020001010100010100010002000200020101000801000200010000000802020101000102010200020600070201010200010500
00020001000001000207010108020001000200020200000101010106010002010001020501000202020802020001010001000102000001020202000102050801010702010102010200010201080001000108020100010200000201010200000000000202
01050102020200020002000000000102010008000200020000020201020102010001020001010000020206010702010105000101010202020200000201000201000200010101010002000106020002010800000100020102010002010200000202050101
08020202020002020100080100000001060201010200000101000201020102000002020202000002020000020001010108020500060202010202000000020002000202000102010101060201060100020002010001010101080102080601020102010200
02000700010101000001010202020200010800020002010001060101000001010000070502000001020202010100010202020002000102020002000200000000000002010002020100010001000102020002000106010001010800020206010101010002
00020700060200020008020101010102020102000100020201010200000100020200000102070201010102010100020706010802020001000202020100000002020100000108000100010500000000000002050100020100020200000001000101000200
07000202020201000202000201010101060000000107000206010201020202010007020206000202000202050101010000020601020002010001060101020602000208000202020702010100000102020001080500020205000200070002060201010200
00060000010000000101000101050202020501010102000202000001020000000000010201020501000601000002010100000100010001000100020002000002000208000102000001000101010005050100020201020102000000000100000000000001
02010008020100000205020102010002020102020100000002020201070800080200020100080106020608020102020101000000000201000202020001000101020200020102020705000101080002000202000001020202080202000000020200000701
00020200010202020201020602020200000002010002010000050000020202000201010000020002010200010206020501020002000100000101060200000202020100000100060701000201020102010000020201010001000101010002000102000000
00020106020100060100010101010002010100000506000202060001000101010000000202020700000000000101010200000102020000010100020201000001000101060201000001010202010200010002070108010202010102010201000201000101
01000002020202010600010000020002010205000101000500020202010101080000010000010000010200010200000102010200000102000100000002010100020101020701010100010000010100020201020000000808000101020100000202010202
00080202000001000205010100000000020001020002000000050201010100050102000208080201010102010201000100000000020100000108020208020000000002010102010200020201000501000001020207010008010100010200010502000100
08010002000200020000020600000202010002060202010100020001010100000002000100000706010100020102020102020002010106000800010000020002070701010101000000020002000105020102010101000005010701000202020101010101
00070000020002010200000102070101020000000200020200000000020200000208010100000207020202000008020102000201000001010101020701020501020101020101020102020008010001020201010102020502020500000202000201000701
02010101010201020107020100010107020001010001010100020201010200010201010201020201020100020100020000020502070201020101060106020002000001020006010100020700070200000205020208020200000102020200020100000205
02000200000102000100010202000002010700010002010805020001010500020102000101020200000206000001020000000001000000020106010206010700020102020201010001020002020101020200010606010202000100010102020105020201
00020100050000020000010002070201020101000202010202010501000201010001000100020200010000010202020001010200020100000202020201020100000102020101070002000001080002020200000201010205000702020201010200020200
02010001000200020008000008020201010201000201010201000002020101000001000001000800000100020002020100010200020200080102020200020200010101010700010101070202000102020606010202020001080108000200010202010002
01000008020201010101010202020006020001020802020202000000000206010200020107020000010000020001020605010208010200020100000101000202020202000501010201010001010001000201010500080207000102020705000102020201
00020102010202020001020201000102010202000000000202000000000200010007000001000001020007010206000102020002010200020200000101010001010205000201020200010100050200000002000102000002010101020105010001080000
02020101000102010202000101020008080200000002010205000202010202000200000001020600000100010101010200010200080100010001010002020207020202060201000002010202000200020102010002020201010000020201000100020100
01020501010207010001020000010202000205010200000200000001010202010602020201010101010100020001010700000100000000010102000801020100000200050101020202020102020201020200010501000101010202010702010607020506
06010100020102010202000100000000020100020100010200010102010101020202000002020100010801060101020200000202010202000001010001000201010206020000010201020101020102010200010002000102000000000000020202000001
05000102080802020001010702020101020100010201000101000002000002020606010000010201020208010002000102000200020100000200010001010106010001000200020101000201000200000100010701070102020202000100010201000001
00020000020002020202010202010202010802020000000201000100010101010200020001020000020002000200080802000201000202000200020002020000020101000001010800050100000202010102000701060102080200020001010001010100
00000601000006000000010002010100020100000101020001010101010002020100020200010106010108020100070202000001010006020502010200000200000602020100010201020102050201000101010000020001000208020000010202010201
00020101050108020202000502010202010102000006000100000002010000010200000102000101020102000002010201010102010202010200000200000200020000010002000100020200020102010108000102010202010101080201020207000000
06000601010501000201050200000501010201010201000001020001010001010002010100000001020002020208000201000101010208020200020701010101000202050101020101020202010006020102070200010000010101020102000100020101
01010001020200070201000001010200080200000000000001020007010201010102020200020100000002020102020008010000000208020102020502020000050201020201020100000500000000000101000202020602000001010200010701020201
01010105000002020201000201000000010202060000020201010101010102000100020201010006020202020102020001000101010102020102080102020200010502020805010000000101010001000200010000000001010601020101000100020102
02020202010200050001010101070000010100000002020002050100010200000100000202010001020500080501010100000602000200010700010001020102020200010100020002020000000000010100050002020202010205000702010101000200
01020801000201010202010201010201070602010100020102010000020002020101020601000801000101010001020101000000010001000202010200020202010205000002000202000100010001000200020507020100000202020100010000000000
00010500010100000202020202000000010002020106000108050208000702010108020002000002000101000100020000010000010702000100010700000201010100000100010102010202010100000201070102010200000002020702010201000001
00010001000002000701000200000102020200020101070201020502020100020100010100020101000100020100000000020202010201020001020002000001010202070200020102000101020201020201010108000001020201010002010101020100
00000000080105010101010101000002010002060200060000050501000200000002010007010707010002020202010200000202000001010201020000020102010102020102020002020001010002010001000000020001000001060005020102020101
02000508000601010201000002020201000201020000000201010008000500050000020007000000000000020100010200070208020005020000020102020206010102010106000101020201020601050201000101000100000202000100020201020207
00080202000101010002010102010202010000010202010208000008000202010207000101000002010101010105050200020100000001050102020102010200000002000101020208020006010100020105000001010201020100000202020201010000
01000201010101010107020100000102000100000201000202020201020202060201010200020102020107000100000102010001020000020200020200000108000000010002020000010207000201010100020100080202020601020101000201010501
00010002010000070002000206000101000201000201000100010002020000010101010200010100020200050100000200000801020601010002010002000202000200060700000001010101010000020100010200000802020200010202020002020002
00000200020100010102020008070200010102000601020100020101020202020207020100020202000802020200000201010200010000000002020002000002010100000100020101010102010502020101010000010200020202080202000200000100
08010602010000000100020200000101010002020201000202020801020101000201000202010001000802020101020202020100000101080101000002020101020102010702000200000000000202010002010201010000000100070700020200000208
00020800020200020102010100020200080002000100010202010101020200080100050202020202010108000100020101010208020100000001010207020101010201020101000200020202000701000001000102010200010105000202080100020202
01000000000101000002050200000200010800020201070000020101000202070201020101050002010106010002050202070202000201010000020100000200020201000102020101010202000102070100000201020000000202010100000208010002
00010100010000020000000202010202000000020102020200020800020202020200020008010102020100010100010000010100020701010100000101010100010001070101000002020800050000020002020201020000020100020202000000070002
01020201010206010002010001010200000100010102000001000600010101000002000108000000020101020102020102000701000201000201000105020200000102000101010500000002010002010201010502000702000201020107010801010101
02050201010202000801010200010201010101000101020002010207000100080106000206010200020102000001010100020002000100020201020006010000010100000200060200000100000001000201000801080700010201010101010102000600
02010202020002010001010200080001010200000000080101020000020201020000010200010802000700000101000802000200010201000202020701020002010801000801010200020200010102010000000102010200020701010100010800020008
02020000000202010100000102020208020000010101020101000200000000070101020802020001010100010002020106010000080200010202050002010100020500050205020202020002010202000102010101010202010002020700020100010000
00010100020101010001020202010002000202010100070702020102060601010001010102000200010100020105000100070100000200000207000101020502020105010001000000000001000101020202020101000202000000010200000100020102
00020200010201010002060002000202020800020200000202000102000200010200000101010202020208020001000100080500000000000100020200000000020701050101010000070100000701010002000001020202010202020006020200010002
07000805010102000200010005010001000100010101000201000501020200020201020102020206010100010202010200020101020002020002010702010200000208050202000000000100010202020202000700010001010100010201010102080601
02050100010001010700000001020001000100000102020101020102000201070000000002000200000102020002000202010102000101010000010201000500020101000002010201020002000200010201020101000000000202010101020701010102
00000108020202000000000701000002000101010101000100000101000100010801000000000101010100010108020000010108010201020107010101020208020501000207000108000201000105010002000200000100020001060001000200020002
